Trail Jordan 	_ follow Jordan <none> <none> <none> <none> <none> <none> <none> <none> <none> <none> <none> <none> <none> <none> <none> <none> <none>
chase Jordan 	_ follow Jordan <none> <none> <none> <none> <none> <none> <none> <none> <none> <none> <none> <none> <none> <none> <none> <none> <none>
Follow Taylor 	_ follow Taylor <none> <none> <none> <none> <none> <none> <none> <none> <none> <none> <none> <none> <none> <none> <none> <none> <none>
Follow Tracy. 	_ follow Tracy <none> <none> <none> <none> <none> <none> <none> <none> <none> <none> <none> <none> <none> <none> <none> <none> <none>
Go with Robin 	_ follow Robin <none> <none> <none> <none> <none> <none> <none> <none> <none> <none> <none> <none> <none> <none> <none> <none> <none>
go to bedroom 	_ go <none> <none> <none> <none> <none> bedroom <none> <none> <none> <none> <none> <none> <none> <none> <none> <none> <none> <none>
Go with Taylor 	_ follow Taylor <none> <none> <none> <none> <none> <none> <none> <none> <none> <none> <none> <none> <none> <none> <none> <none> <none>
get me the fork 	_ bring fork <none> <none> <none> <none> <none> operator <none> <none> <none> <none> <none> <none> <none> <none> <none> <none> <none>
Get me the knife 	_ bring knife <none> <none> <none> <none> <none> operator <none> <none> <none> <none> <none> <none> <none> <none> <none> <none> <none>
bring me the bag 	_ bring bag <none> <none> <none> <none> <none> operator <none> <none> <none> <none> <none> <none> <none> <none> <none> <none> <none>
Stay with Jordan 	_ follow Jordan <none> <none> <none> <none> <none> <none> <none> <none> <none> <none> <none> <none> <none> <none> <none> <none> <none>
Find the shampoo 	_ bring shampoo <none> <none> <none> <none> <none> operator <none> <none> <none> <none> <none> <none> <none> <none> <none> <none> <none>
go to the kitchen 	_ go <none> <none> <none> <none> <none> kitchen <none> <none> <none> <none> <none> <none> <none> <none> <none> <none> <none> <none>
Bring me the soap 	_ bring soap <none> <none> <none> <none> <none> operator <none> <none> <none> <none> <none> <none> <none> <none> <none> <none> <none>
Hand me that coke 	_ bring coke <none> <none> <none> <none> <none> operator <none> <none> <none> <none> <none> <none> <none> <none> <none> <none> <none>
bring me the soap 	_ bring soap <none> <none> <none> <none> <none> operator <none> <none> <none> <none> <none> <none> <none> <none> <none> <none> <none>
give me the apple 	_ bring apple <none> <none> <none> <none> <none> operator <none> <none> <none> <none> <none> <none> <none> <none> <none> <none> <none>
pass me the fork. 	_ bring fork <none> <none> <none> <none> <none> operator <none> <none> <none> <none> <none> <none> <none> <none> <none> <none> <none>
retrieve the soap 	_ bring soap <none> <none> <none> <none> <none> operator <none> <none> <none> <none> <none> <none> <none> <none> <none> <none> <none>
Give me the apple. 	_ bring apple <none> <none> <none> <none> <none> operator <none> <none> <none> <none> <none> <none> <none> <none> <none> <none> <none>
Give me the sponge 	_ bring sponge <none> <none> <none> <none> <none> operator <none> <none> <none> <none> <none> <none> <none> <none> <none> <none> <none>
Hand me the apple. 	_ bring apple <none> <none> <none> <none> <none> operator <none> <none> <none> <none> <none> <none> <none> <none> <none> <none> <none>
Serve Jordan pasta. 	_ bring pasta <none> <none> <none> <none> <none> Jordan <none> <none> <none> <none> <none> <none> <none> <none> <none> <none> <none>
Bring a fork to me. 	_ bring fork <none> <none> <none> <none> <none> operator <none> <none> <none> <none> <none> <none> <none> <none> <none> <none> <none>
Bring me chocolate. 	_ bring chocolate <none> <none> <none> <none> <none> operator <none> <none> <none> <none> <none> <none> <none> <none> <none> <none> <none>
Bring me the apple. 	_ bring apple <none> <none> <none> <none> <none> operator <none> <none> <none> <none> <none> <none> <none> <none> <none> <none> <none>
bring the tea to me 	_ bring tea <none> <none> <none> <none> <none> operator <none> <none> <none> <none> <none> <none> <none> <none> <none> <none> <none>
help me get the mug 	_ bring mug <none> <none> <none> <none> <none> operator <none> <none> <none> <none> <none> <none> <none> <none> <none> <none> <none>
Please follow Robin 	_ follow Robin <none> <none> <none> <none> <none> <none> <none> <none> <none> <none> <none> <none> <none> <none> <none> <none> <none>
Robot, follow Alex. 	_ follow Alex <none> <none> <none> <none> <none> <none> <none> <none> <none> <none> <none> <none> <none> <none> <none> <none> <none>
Trail behind Robin. 	_ follow Robin <none> <none> <none> <none> <none> <none> <none> <none> <none> <none> <none> <none> <none> <none> <none> <none> <none>
give robin the knife 	_ bring knife <none> <none> <none> <none> <none> Robin <none> <none> <none> <none> <none> <none> <none> <none> <none> <none> <none>
Bring the mug to me. 	_ bring mug <none> <none> <none> <none> <none> operator <none> <none> <none> <none> <none> <none> <none> <none> <none> <none> <none>
Deliver me chocolate 	_ bring chocolate <none> <none> <none> <none> <none> operator <none> <none> <none> <none> <none> <none> <none> <none> <none> <none> <none>
Go retrieve the box. 	_ bring box <none> <none> <none> <none> <none> operator <none> <none> <none> <none> <none> <none> <none> <none> <none> <none> <none>
Who's in the bedroom 	_ find person <none> <none> <none> <none> bedroom operator <none> <none> <none> <none> <none> <none> name <none> <none> <none> <none>
Place beer on stove. 	_ bring beer <none> <none> <none> <none> <none> place on stove <none> <none> <none> <none> <none> <none> <none> <none> <none>
Get me a knife please 	_ bring knife <none> <none> <none> <none> <none> operator <none> <none> <none> <none> <none> <none> <none> <none> <none> <none> <none>
please bring me water 	_ bring water <none> <none> <none> <none> <none> operator <none> <none> <none> <none> <none> <none> <none> <none> <none> <none> <none>
please go after Tracy 	_ follow Tracy <none> <none> <none> <none> <none> <none> <none> <none> <none> <none> <none> <none> <none> <none> <none> <none> <none>
Go to the dining room 	_ go <none> <none> <none> <none> <none> dining_room <none> <none> <none> <none> <none> <none> <none> <none> <none> <none> <none> <none>
Head to the bathroom. 	_ go <none> <none> <none> <none> <none> bathroom <none> <none> <none> <none> <none> <none> <none> <none> <none> <none> <none> <none>
go to the dining room 	_ go <none> <none> <none> <none> <none> dining_room <none> <none> <none> <none> <none> <none> <none> <none> <none> <none> <none> <none>
Bring the knife to me. 	_ bring knife <none> <none> <none> <none> <none> operator <none> <none> <none> <none> <none> <none> <none> <none> <none> <none> <none>
Hand me the box please 	_ bring box <none> <none> <none> <none> <none> operator <none> <none> <none> <none> <none> <none> <none> <none> <none> <none> <none>
Please give me the bag 	_ bring bag <none> <none> <none> <none> <none> operator <none> <none> <none> <none> <none> <none> <none> <none> <none> <none> <none>
bring me the chocolate 	_ bring chocolate <none> <none> <none> <none> <none> operator <none> <none> <none> <none> <none> <none> <none> <none> <none> <none> <none>
Who is at the cabinet? 	_ find person at cabinet <none> <none> <none> operator <none> <none> <none> <none> <none> <none> name <none> <none> <none> <none>
Who is in the bedroom? 	_ find person <none> <none> <none> <none> bedroom operator <none> <none> <none> <none> <none> <none> name <none> <none> <none> <none>
Find Tracy. 	_ find Tracy <none> <none> <none> <none> <none> operator <none> <none> <none> <none> <none> <none> where <none> <none> <none> <none>
Go after Taylor please 	_ follow Taylor <none> <none> <none> <none> <none> <none> <none> <none> <none> <none> <none> <none> <none> <none> <none> <none> <none>
please go after Taylor 	_ follow Taylor <none> <none> <none> <none> <none> <none> <none> <none> <none> <none> <none> <none> <none> <none> <none> <none> <none>
proceed to the bedroom 	_ go <none> <none> <none> <none> <none> bedroom <none> <none> <none> <none> <none> <none> <none> <none> <none> <none> <none> <none>
Can I have the big dish 	_ bring dish <none> <none> <none> <none> <none> operator <none> <none> <none> <none> <none> <none> <none> largest <none> <none> <none>
please pass me the mug. 	_ bring mug <none> <none> <none> <none> <none> operator <none> <none> <none> <none> <none> <none> <none> <none> <none> <none> <none>
Who is in the corridor? 	_ find person in corridor <none> <none> <none> operator <none> <none> <none> <none> <none> <none> name <none> <none> <none> <none>
Fill a bowl with cereal 	_ bring cereal <none> <none> <none> <none> <none> place in bowl <none> <none> <none> <none> <none> <none> <none> <none> <none>
make cereal in the bowl 	_ bring cereal <none> <none> <none> <none> <none> place in bowl <none> <none> <none> <none> <none> <none> <none> <none> <none>
pour cereal in the bowl 	_ bring cereal <none> <none> <none> <none> <none> place in bowl <none> <none> <none> <none> <none> <none> <none> <none> <none>
Give Michael a teaspoon. 	_ bring teaspoon <none> <none> <none> <none> <none> Michael <none> <none> <none> <none> <none> <none> <none> <none> <none> <none> <none>
pass Michael a teaspoon 	_ bring teaspoon <none> <none> <none> <none> <none> Michael <none> <none> <none> <none> <none> <none> <none> <none> <none> <none> <none>
Give Jordan a teaspoon. 	_ bring teaspoon <none> <none> <none> <none> <none> Jordan <none> <none> <none> <none> <none> <none> <none> <none> <none> <none> <none>
Please bring me the soap 	_ bring soap <none> <none> <none> <none> <none> operator <none> <none> <none> <none> <none> <none> <none> <none> <none> <none> <none>
Please pass me the pasta 	_ bring pasta <none> <none> <none> <none> <none> operator <none> <none> <none> <none> <none> <none> <none> <none> <none> <none> <none>
bring me an apple please 	_ bring apple <none> <none> <none> <none> <none> operator <none> <none> <none> <none> <none> <none> <none> <none> <none> <none> <none>
Who's in the living room 	_ find person <none> <none> <none> <none> living_room operator <none> <none> <none> <none> <none> <none> name <none> <none> <none> <none>
put the pasta on the bed 	_ bring pasta <none> <none> <none> <none> <none> place on bed <none> <none> <none> <none> <none> <none> <none> <none> <none>
Bring Hayden to the desk 	_ guide Hayden <none> <none> <none> <none> <none> place at desk <none> <none> <none> <none> <none> <none> <none> <none> <none>
Go to the kitchen please 	_ go <none> <none> <none> <none> <none> kitchen <none> <none> <none> <none> <none> <none> <none> <none> <none> <none> <none> <none>
Navigate to living room. 	_ go <none> <none> <none> <none> <none> living_room <none> <none> <none> <none> <none> <none> <none> <none> <none> <none> <none> <none>
Navigate to the bedroom. 	_ go <none> <none> <none> <none> <none> bedroom <none> <none> <none> <none> <none> <none> <none> <none> <none> <none> <none> <none>
Take Jamie to the drawer. 	_ guide Jamie <none> <none> <none> <none> <none> place at drawer <none> <none> <none> <none> <none> <none> <none> <none> <none>
Get the toothpaste for me 	_ bring toothpaste <none> <none> <none> <none> <none> operator <none> <none> <none> <none> <none> <none> <none> <none> <none> <none> <none>
Please bring me the fork. 	_ bring fork <none> <none> <none> <none> <none> operator <none> <none> <none> <none> <none> <none> <none> <none> <none> <none> <none>
Find Alex. 	_ find Alex <none> <none> <none> <none> <none> operator <none> <none> <none> <none> <none> <none> where <none> <none> <none> <none>
Go with him. 	_ follow male <none> <none> <none> <none> <none> <none> <none> <none> <none> <none> <none> <none> <none> <none> <none> <none> <none>
go see Jamie 	_ find Jamie <none> <none> <none> <none> <none> <none> <none> <none> <none> <none> <none> <none> where <none> <none> <none> <none>
lead them 	_ guide person <none> <none> <none> <none> <none> <none> <none> <none> <none> <none> <none> <none> <none> <none> <none> <none> <none>
Bring this banana to Tracy 	_ bring banana <none> <none> <none> <none> <none> Tracy <none> <none> <none> <none> <none> <none> <none> <none> <none> <none> <none>
deliver the knife to robin 	_ bring knife <none> <none> <none> <none> <none> Robin <none> <none> <none> <none> <none> <none> <none> <none> <none> <none> <none>
Please bring me the apple. 	_ bring apple <none> <none> <none> <none> <none> operator <none> <none> <none> <none> <none> <none> <none> <none> <none> <none> <none>
Who is in the living room? 	_ find person <none> <none> <none> <none> living_room operator <none> <none> <none> <none> <none> <none> name <none> <none> <none> <none>
Please find me the shampoo 	_ bring shampoo <none> <none> <none> <none> <none> operator <none> <none> <none> <none> <none> <none> <none> <none> <none> <none> <none>
lets go to the dining room 	_ go <none> <none> <none> <none> <none> dining_room <none> <none> <none> <none> <none> <none> <none> <none> <none> <none> <none> <none>
Meet Alex. 	_ find Alex <none> <none> <none> <none> <none> operator <none> <none> <none> <none> <none> <none> where <none> <none> <none> <none>
accompany him 	_ follow male <none> <none> <none> <none> <none> <none> <none> <none> <none> <none> <none> <none> <none> <none> <none> <none> <none>
Take these pickles to Alex. 	_ bring pickles <none> <none> <none> <none> <none> Alex <none> <none> <none> <none> <none> <none> <none> <none> <none> <none> <none>
please to Jordan give pasta 	_ bring pasta <none> <none> <none> <none> <none> Jordan <none> <none> <none> <none> <none> <none> <none> <none> <none> <none> <none>
Bring the fork to me please 	_ bring fork <none> <none> <none> <none> <none> operator <none> <none> <none> <none> <none> <none> <none> <none> <none> <none> <none>
Take the tuna fish to Jamie 	_ bring tuna <none> <none> <none> <none> <none> Jamie <none> <none> <none> <none> <none> <none> <none> <none> <none> <none> <none>
Pour cereal into the bowls. 	_ bring cereal <none> <none> <none> <none> <none> place in bowl <none> <none> <none> <none> <none> <none> <none> <none> <none>
Get the pickles from the dishwasher 	_ bring pickles in dishwasher <none> <none> <none> operator <none> <none> <none> <none> <none> <none> <none> <none> <none> <none> <none>
Show Jordan to the cupboard 	_ guide Jordan <none> <none> <none> <none> <none> place at cupboard <none> <none> <none> <none> <none> <none> <none> <none> <none>
Relocate to the dining room 	_ go <none> <none> <none> <none> <none> dining_room <none> <none> <none> <none> <none> <none> <none> <none> <none> <none> <none> <none>
lead the object to the sofa 	_ bring object <none> <none> <none> <none> <none> place on sofa <none> <none> <none> <none> <none> <none> <none> <none> <none>
Please fetch that soap to me 	_ bring soap <none> <none> <none> <none> <none> operator <none> <none> <none> <none> <none> <none> <none> <none> <none> <none> <none>
Find three items in the room 	_ bring object <none> <none> <none> <none> <none> operator <none> <none> <none> <none> <none> <none> <none> <none> 3 <none> <none>
go to toilet 	_ go <none> at toilet <none> <none> <none> <none> <none> <none> <none> <none> <none> <none> <none> <none> <none> <none> <none>
lead Morgan 	_ guide Morgan <none> <none> <none> <none> <none> <none> <none> <none> <none> <none> <none> <none> <none> <none> <none> <none> <none>
Bring Hayden to the freezer. 	_ guide Hayden <none> <none> <none> <none> <none> place at fridge <none> <none> <none> <none> <none> <none> <none> <none> <none>
Bring Peyton to the counter. 	_ guide Peyton <none> <none> <none> <none> <none> place at counter <none> <none> <none> <none> <none> <none> <none> <none> <none>
Go to the living room please 	_ go <none> <none> <none> <none> <none> living_room <none> <none> <none> <none> <none> <none> <none> <none> <none> <none> <none> <none>
give the teaspoon to Michael 	_ bring teaspoon <none> <none> <none> <none> <none> Michael <none> <none> <none> <none> <none> <none> <none> <none> <none> <none> <none>
Robot, who is in the kitchen? 	_ find person <none> <none> <none> <none> kitchen operator <none> <none> <none> <none> <none> <none> name <none> <none> <none> <none>
What is the name of the person 	_ find person <none> <none> <none> <none> <none> operator <none> <none> <none> <none> <none> <none> name <none> <none> <none> <none>
go to the bar 	_ go <none> at bar <none> <none> <none> <none> <none> <none> <none> <none> <none> <none> <none> <none> <none> <none> <none>
take Hayden 	_ guide Hayden <none> <none> <none> <none> <none> <none> <none> <none> <none> <none> <none> <none> <none> <none> <none> <none> <none>
Is there beer in the corridor 	_ bring beer in corridor <none> <none> <none> operator <none> <none> <none> <none> <none> <none> <none> <none> <none> <none> <none>
Go to the dining room thanks. 	_ go <none> <none> <none> <none> <none> dining_room <none> <none> <none> <none> <none> <none> <none> <none> <none> <none> <none> <none>
Please go to the living room. 	_ go <none> <none> <none> <none> <none> living_room <none> <none> <none> <none> <none> <none> <none> <none> <none> <none> <none> <none>
What's the pose of the person 	_ find person <none> <none> <none> <none> <none> <none> <none> <none> <none> <none> <none> <none> guesture <none> <none> <none> <none>
How many beer are on the sink? 	_ find beer on sink <none> <none> <none> <none> <none> <none> <none> <none> <none> <none> count <none> <none> <none> <none>
How many beers are on the sink 	_ find beer on sink <none> <none> <none> <none> <none> <none> <none> <none> <none> <none> count <none> <none> <none> <none>
Please get me the choco flakes 	_ bring chocoflake <none> <none> <none> <none> <none> operator <none> <none> <none> <none> <none> <none> <none> <none> <none> <none> <none>
get the fork 	_ bring fork <none> <none> <none> <none> <none> operator <none> <none> <none> <none> <none> <none> <none> <none> <none> <none> <none>
give it to me 	_ bring object <none> <none> <none> <none> <none> operator <none> <none> <none> <none> <none> <none> <none> <none> <none> <none> <none>
Guide Tracy to the side table. 	_ guide Tracy <none> <none> <none> <none> <none> place at table <none> <none> <none> <none> <none> <none> <none> <none> <none>
Take Taylor to the baby chair. 	_ guide Taylor <none> <none> <none> <none> <none> place at chair <none> <none> <none> <none> <none> <none> <none> <none> <none>
please put cereal in the bowls 	_ bring cereal <none> <none> <none> <none> <none> place in bowl <none> <none> <none> <none> <none> <none> <none> <none> <none>
Let me help you to the counter 	_ guide operator <none> <none> <none> <none> <none> place at counter <none> <none> <none> <none> <none> <none> <none> <none> <none>
Please help Michael get to bed 	_ guide Michael <none> <none> <none> <none> <none> place at bed <none> <none> <none> <none> <none> <none> <none> <none> <none>
Find the peach in the bathroom 	_ bring peach <none> <none> <none> <none> bathroom operator <none> <none> <none> <none> <none> <none> <none> <none> <none> <none> <none>
find the peach in the bathroom 	_ bring peach <none> <none> <none> <none> bathroom operator <none> <none> <none> <none> <none> <none> <none> <none> <none> <none> <none>
look in the dining for the cup 	_ bring cup <none> <none> <none> <none> dining_room operator <none> <none> <none> <none> <none> <none> <none> <none> <none> <none> <none>
Go meet Peyton 	_ find Peyton <none> <none> <none> <none> <none> operator <none> <none> <none> <none> <none> <none> where <none> <none> <none> <none>
go with them 	_ follow person <none> <none> <none> <none> <none> <none> <none> <none> <none> <none> <none> <none> <none> <none> <none> <none> <none>
Can you get the knife to Robin? 	_ bring knife <none> <none> <none> <none> <none> Robin <none> <none> <none> <none> <none> <none> <none> <none> <none> <none> <none>
Bring me some pasta dear robot. 	_ bring pasta <none> <none> <none> <none> <none> operator <none> <none> <none> <none> <none> <none> <none> <none> <none> <none> <none>
bring me the toothpaste please. 	_ bring toothpaste <none> <none> <none> <none> <none> operator <none> <none> <none> <none> <none> <none> <none> <none> <none> <none> <none>
please the tuna, bring it to me 	_ bring tuna <none> <none> <none> <none> <none> operator <none> <none> <none> <none> <none> <none> <none> <none> <none> <none> <none>
Pour some cereal into this bowl 	_ bring cereal <none> <none> <none> <none> <none> place in bowl <none> <none> <none> <none> <none> <none> <none> <none> <none>
Bring the fork to the microwave 	_ bring fork <none> <none> <none> <none> <none> place on microwave <none> <none> <none> <none> <none> <none> <none> <none> <none>
Place the apple on the counter. 	_ bring apple <none> <none> <none> <none> <none> place on counter <none> <none> <none> <none> <none> <none> <none> <none> <none>
Put the big dish on the shower. 	_ bring dish <none> <none> <none> <none> <none> place on shower <none> <none> <none> <none> <none> largest <none> <none> <none>
Take the fork to the microwave. 	_ bring fork <none> <none> <none> <none> <none> place on microwave <none> <none> <none> <none> <none> <none> <none> <none> <none>
Please take Michael to the bed. 	_ guide Michael <none> <none> <none> <none> <none> place at bed <none> <none> <none> <none> <none> <none> <none> <none> <none>
Find the pasta in the bathroom. 	_ bring pasta <none> <none> <none> <none> bathroom operator <none> <none> <none> <none> <none> <none> <none> <none> <none> <none> <none>
Locate a sponge in the kitchen. 	_ bring sponge <none> <none> <none> <none> kitchen operator <none> <none> <none> <none> <none> <none> <none> <none> <none> <none> <none>
Bring me the pasta on the table 	_ bring pasta on table <none> <none> <none> operator <none> <none> <none> <none> <none> <none> <none> <none> <none> <none> <none>
give me the shampoo in the sink 	_ bring shampoo in sink <none> <none> <none> operator <none> <none> <none> <none> <none> <none> <none> <none> <none> <none> <none>
Greet Alex. 	_ find Alex <none> <none> <none> <none> <none> operator <none> <none> <none> <none> <none> <none> where <none> <none> <none> <none>
bring him inside 	_ guide male <none> <none> <none> <none> <none> place at <none> <none> <none> <none> <none> <none> <none> <none> <none> <none>
Take Jordan from dresser to sofa 	_ guide Jordan at dresser <none> <none> <none> place at sofa <none> <none> <none> <none> <none> <none> <none> <none> <none>
Get 3 items from the dining room 	_ bring object <none> <none> <none> <none> dining_room operator <none> <none> <none> <none> <none> <none> <none> 3 <none> <none> <none>
Can you pour cereal in the bowl. 	_ bring cereal <none> <none> <none> <none> <none> place in bowl <none> <none> <none> <none> <none> <none> <none> <none> <none>
Please put cereal into this bowl 	_ bring cereal <none> <none> <none> <none> <none> place in bowl <none> <none> <none> <none> <none> <none> <none> <none> <none>
Bring the soap to the nightstand 	_ bring soap <none> <none> <none> <none> <none> place on nightstand <none> <none> <none> <none> <none> <none> <none> <none> <none>
Move the apple to the side table 	_ bring apple <none> <none> <none> <none> <none> place on table <none> <none> <none> <none> <none> <none> <none> <none> <none>
Put the teaspoon on the counter 	_ bring teaspoon <none> <none> <none> <none> <none> place on counter <none> <none> <none> <none> <none> <none> <none> <none> <none>
place the tray on the dishwasher 	_ bring tray <none> <none> <none> <none> <none> place on dishwasher <none> <none> <none> <none> <none> <none> <none> <none> <none>
Are there noodles in the kitchen 	_ bring noodles <none> <none> <none> <none> kitchen operator <none> <none> <none> <none> <none> <none> <none> <none> <none> <none> <none>
Find the beer in the living room 	_ bring beer <none> <none> <none> <none> living_room operator <none> <none> <none> <none> <none> <none> <none> <none> <none> <none> <none>
Find the cookies in the kitchen. 	_ bring cookies <none> <none> <none> <none> kitchen operator <none> <none> <none> <none> <none> <none> <none> <none> <none> <none> <none>
Find the sponge from the kitchen 	_ bring sponge <none> <none> <none> <none> kitchen operator <none> <none> <none> <none> <none> <none> <none> <none> <none> <none> <none>
find the shampoo in the bathroom 	_ bring shampoo <none> <none> <none> <none> bathroom operator <none> <none> <none> <none> <none> <none> <none> <none> <none> <none> <none>
Come into the dining room please 	_ go <none> <none> <none> <none> <none> dining_room <none> <none> <none> <none> <none> <none> <none> <none> <none> <none> <none> <none>
get me the pear from the dresser 	_ bring pear in dresser <none> <none> <none> operator <none> <none> <none> <none> <none> <none> <none> <none> <none> <none> <none>
Move the objects from the shower 	_ bring object in shower <none> <none> <none> operator <none> <none> <none> <none> <none> <none> <none> <none> <none> <none> <none>
how many men are in the corridor 	_ find male in corridor <none> <none> <none> operator <none> <none> <none> <none> <none> <none> count <none> <none> <none> <none>
How many beers are on the toilet? 	_ find beer on toilet <none> <none> <none> operator <none> <none> <none> <none> <none> <none> count <none> <none> <none> <none>
How many cokes are in the freezer 	_ find coke in fridge <none> <none> <none> operator <none> <none> <none> <none> <none> <none> count <none> <none> <none> <none>
find the items in the living room 	_ bring object <none> <none> <none> <none> living_room operator <none> <none> <none> <none> <none> <none> <none> <none> <none> <none> <none>
please bring Michael the big dish 	_ bring dish <none> <none> <none> <none> <none> Michael <none> <none> <none> <none> <none> <none> <none> largest <none> <none> <none>
How many objects are in the sink? 	_ find object in sink <none> <none> <none> operator <none> <none> <none> <none> <none> <none> count <none> <none> <none> <none>
Take Taylor from sink to counter. 	_ guide Taylor at sink <none> <none> <none> place at counter <none> <none> <none> <none> <none> <none> <none> <none> <none>
Can you bring me the chocoflakes 	_ bring chocoflake <none> <none> <none> <none> <none> operator <none> <none> <none> <none> <none> <none> <none> <none> <none> <none> <none>
Who is the person at the cabinet? 	_ find person at cabinet <none> <none> <none> operator <none> <none> <none> <none> <none> <none> name <none> <none> <none> <none>
Who is the person at the counter? 	_ find person at counter <none> <none> <none> operator <none> <none> <none> <none> <none> <none> name <none> <none> <none> <none>
Please bring my glass to the desk 	_ bring glass <none> <none> <none> <none> <none> place on desk <none> <none> <none> <none> <none> <none> <none> <none> <none>
Set the cookies on the nightstand 	_ bring cookies <none> <none> <none> <none> <none> place on nightstand <none> <none> <none> <none> <none> <none> <none> <none> <none>
Take the teaspoon to the counter. 	_ bring teaspoon <none> <none> <none> <none> <none> place on counter <none> <none> <none> <none> <none> <none> <none> <none> <none>
Go to the kitchen 	_ go <none> <none> <none> <none> <none> kitchen <none> <none> <none> <none> <none> <none> <none> <none> <none> <none> <none> <none>
get the tea 	_ bring tea <none> <none> <none> <none> <none> operator <none> <none> <none> <none> <none> <none> <none> <none> <none> <none> <none>
Seek for the coke in the bedroom. 	_ bring coke <none> <none> <none> <none> bedroom operator <none> <none> <none> <none> <none> <none> <none> <none> <none> <none> <none>
There is a pasta in the bathroom. 	_ bring pasta <none> <none> <none> <none> bathroom operator <none> <none> <none> <none> <none> <none> <none> <none> <none> <none> <none>
pass me the box on the dishwasher 	_ bring box on dishwasher <none> <none> <none> operator <none> <none> <none> <none> <none> <none> <none> <none> <none> <none> <none>
Get the cereal from the armchair. 	_ bring cereal in chair <none> <none> <none> operator <none> <none> <none> <none> <none> <none> <none> <none> <none> <none> <none>
How many men are in the corridor? 	_ find male in corridor <none> <none> <none> operator <none> <none> <none> <none> <none> <none> count <none> <none> <none> <none>
Accompany Alex after meeting them. 	_ follow Alex <none> <none> <none> <none> <none> <none> <none> <none> <none> <none> <none> <none> <none> <none> <none> <none> <none>
Please greet Morgan 	_ find Morgan <none> <none> <none> <none> <none> operator <none> <none> <none> <none> <none> <none> where <none> <none> <none> <none>
guide them 	_ guide person <none> <none> <none> <none> <none> place at <none> <none> <none> <none> <none> <none> <none> <none> <none> <none>
find me the things in the bathroom 	_ bring object <none> <none> <none> <none> bathroom operator <none> <none> <none> <none> <none> <none> <none> <none> <none> <none> <none>
find the things in the living room 	_ bring object <none> <none> <none> <none> living_room operator <none> <none> <none> <none> <none> <none> <none> <none> <none> <none> <none>
How many things are in that drawer 	_ find object in drawer <none> <none> <none> operator <none> <none> <none> <none> <none> <none> count <none> <none> <none> <none>
How many things are in the freezer 	_ find object in fridge <none> <none> <none> operator <none> <none> <none> <none> <none> <none> count <none> <none> <none> <none>
get the large dishes from the sink 	_ bring dish in sink <none> <none> <none> operator <none> <none> <none> <none> <none> <none> <none> largest <none> <none> <none>
Put the melon on the coffee table. 	_ bring melon <none> <none> <none> <none> <none> place on table <none> <none> <none> <none> <none> <none> <none> <none> <none>
Take the milk to the table please. 	_ bring milk <none> <none> <none> <none> <none> place on table <none> <none> <none> <none> <none> <none> <none> <none> <none>
place the cookies on the nightstand 	_ bring cookies <none> <none> <none> <none> <none> place on nightstand <none> <none> <none> <none> <none> <none> <none> <none> <none>
place the teaspoon on the counter 	_ bring teaspoon <none> <none> <none> <none> <none> place on counter <none> <none> <none> <none> <none> <none> <none> <none> <none>
put the banana on the center table 	_ bring banana <none> <none> <none> <none> <none> place on table <none> <none> <none> <none> <none> <none> <none> <none> <none>
take this teaspoon to the counter 	_ bring teaspoon <none> <none> <none> <none> <none> place on counter <none> <none> <none> <none> <none> <none> <none> <none> <none>
Please take Michael to the counter 	_ guide Michael <none> <none> <none> <none> <none> place at counter <none> <none> <none> <none> <none> <none> <none> <none> <none>
Go find the glass in the bathroom. 	_ bring glass <none> <none> <none> <none> bathroom operator <none> <none> <none> <none> <none> <none> <none> <none> <none> <none> <none>
Go find the sponge in the kitchen. 	_ bring sponge <none> <none> <none> <none> kitchen operator <none> <none> <none> <none> <none> <none> <none> <none> <none> <none> <none>
bring me the shampoo from the sink 	_ bring shampoo in sink <none> <none> <none> operator <none> <none> <none> <none> <none> <none> <none> <none> <none> <none> <none>
Kindly move the soap from the sink 	_ bring soap in sink <none> <none> <none> operator <none> <none> <none> <none> <none> <none> <none> <none> <none> <none> <none>
Please meet Morgan 	_ guide Morgan <none> <none> <none> <none> <none> operator <none> <none> <none> <none> <none> <none> <none> <none> <none> <none> <none>
Go to the bathroom 	_ go <none> <none> <none> <none> <none> bathroom <none> <none> <none> <none> <none> <none> <none> <none> <none> <none> <none> <none>
find objects 	_ bring object <none> <none> <none> <none> <none> <none> <none> <none> <none> <none> <none> <none> <none> <none> <none> <none> <none>
Get the shampoo. 	_ bring shampoo <none> <none> <none> <none> <none> operator <none> <none> <none> <none> <none> <none> <none> <none> <none> <none> <none>
bring it to me 	_ bring object <none> <none> <none> <none> <none> operator <none> <none> <none> <none> <none> <none> <none> <none> <none> <none> <none>
What is the biggest item on the sofa 	_ find object on sofa <none> <none> <none> operator <none> <none> <none> <none> <none> <none> name largest <none> <none> <none>
Robot, serve some cereal in a bowl. 	_ bring cereal <none> <none> <none> <none> <none> place in bowl <none> <none> <none> <none> <none> <none> <none> <none> <none>
Take the pickles to the dishwasher. 	_ bring pickles <none> <none> <none> <none> <none> place on dishwasher <none> <none> <none> <none> <none> <none> <none> <none> <none>
how does peyton get to the counter? 	_ guide Peyton <none> <none> <none> <none> <none> place at counter <none> <none> <none> <none> <none> <none> <none> <none> <none>
take Michael to the kitchen counter 	_ guide Michael <none> <none> <none> <none> <none> place at counter <none> <none> kitchen <none> <none> <none> <none> <none> <none>
Go get the shampoo from the kitchen 	_ bring shampoo <none> <none> <none> <none> kitchen operator <none> <none> <none> <none> <none> <none> <none> <none> <none> <none> <none>
Go to the kitchen. 	_ go <none> <none> <none> <none> <none> kitchen <none> <none> <none> <none> <none> <none> <none> <none> <none> <none> <none> <none>
find the tea 	_ bring tea <none> <none> <none> <none> <none> operator <none> <none> <none> <none> <none> <none> <none> <none> <none> <none> <none>
Where is the pasta in the bathroom? 	_ bring pasta <none> <none> <none> <none> bathroom operator <none> <none> <none> <none> <none> <none> <none> <none> <none> <none> <none>
find the corridor where the beer is 	_ bring beer at corridor <none> <none> <none> operator <none> <none> <none> <none> <none> <none> <none> <none> <none> <none> <none>
Bring me the shampoo from the sink. 	_ bring shampoo in sink <none> <none> <none> operator <none> <none> <none> <none> <none> <none> <none> <none> <none> <none> <none>
GET ME THE BOX FROM THE DISHWASHER. 	_ bring box in dishwasher <none> <none> <none> operator <none> <none> <none> <none> <none> <none> <none> <none> <none> <none> <none>
Get me the milk from the microwave. 	_ bring milk in microwave <none> <none> <none> operator <none> <none> <none> <none> <none> <none> <none> <none> <none> <none> <none>
Hand me the napkin from the freezer 	_ bring napkin in fridge <none> <none> <none> operator <none> <none> <none> <none> <none> <none> <none> <none> <none> <none> <none>
from the dishwasher give me the box 	_ bring box in dishwasher <none> <none> <none> operator <none> <none> <none> <none> <none> <none> <none> <none> <none> <none> <none>
how many men are in the living room 	_ find male <none> <none> <none> <none> living_room operator <none> <none> <none> <none> <none> <none> count <none> <none> <none> <none>
How many things are on the bookshelf 	_ find object on bookshelf <none> <none> <none> operator <none> <none> <none> <none> <none> <none> count <none> <none> <none> <none>
Find the shampoo. 	_ bring shampoo <none> <none> <none> <none> <none> operator <none> <none> <none> <none> <none> <none> <none> <none> <none> <none> <none>
What is the name of the chairperson? 	_ answer operator <none> <none> <none> <none> <none> <none> <none> <none> <none> <none> <none> name_of_chairperson <none> <none> <none> <none> <none>
Grab the lightest object on the sofa 	_ bring object on sofa <none> <none> <none> operator <none> <none> <none> <none> <none> <none> <none> lightest <none> <none> <none>
Pour the cereal into the bowl please 	_ bring cereal <none> <none> <none> <none> <none> place in bowl <none> <none> <none> <none> <none> <none> <none> <none> <none>
Put some of the cereal into the bowl 	_ bring cereal <none> <none> <none> <none> <none> place in bowl <none> <none> <none> <none> <none> <none> <none> <none> <none>
Take the fork over to the microwave. 	_ bring fork <none> <none> <none> <none> <none> place on microwave <none> <none> <none> <none> <none> <none> <none> <none> <none>
Please help Jordan find the cupboard 	_ guide Jordan <none> <none> <none> <none> <none> place at cupboard <none> <none> <none> <none> <none> <none> <none> <none> <none>
Go to the bedroom. 	_ go <none> <none> <none> <none> <none> bedroom <none> <none> <none> <none> <none> <none> <none> <none> <none> <none> <none> <none>
find the coke 	_ bring coke <none> <none> <none> <none> <none> operator <none> <none> <none> <none> <none> <none> <none> <none> <none> <none> <none>
Bring me the chips from the dresser. 	_ bring chips in dresser <none> <none> <none> operator <none> <none> <none> <none> <none> <none> <none> <none> <none> <none> <none>
Get me the mug that is on the stove. 	_ bring mug on stove <none> <none> <none> operator <none> <none> <none> <none> <none> <none> <none> <none> <none> <none> <none>
Can you come to Peyton. 	_ guide Peyton <none> <none> <none> <none> <none> operator <none> <none> <none> <none> <none> <none> <none> <none> <none> <none> <none>
find the items 	_ bring object <none> <none> <none> <none> <none> operator <none> <none> <none> <none> <none> <none> <none> <none> <none> <none> <none>
Locate the objects in the dining room 	_ bring object <none> <none> <none> <none> dining_room operator <none> <none> <none> <none> <none> <none> <none> <none> <none> <none> <none>
Who is the person in the living room? 	_ find person <none> <none> <none> <none> living_room operator <none> <none> <none> <none> <none> <none> name <none> <none> <none> <none>
What is the heaviest thing on the desk 	_ find object on desk <none> <none> <none> operator <none> <none> <none> <none> <none> <none> name heaviest <none> <none> <none>
Whats the smallest item on the toilet 	_ find object on toilet <none> <none> <none> operator <none> <none> <none> <none> <none> <none> name smallest <none> <none> <none>
Take the pasta. 	_ bring pasta <none> <none> <none> <none> <none> operator <none> <none> <none> <none> <none> <none> <none> <none> <none> <none> <none>
sit it on the bed 	_ bring object <none> <none> <none> <none> <none> place on bed <none> <none> <none> <none> <none> <none> <none> <none> <none>
What is the lightest thing on the sofa 	_ find object on sofa <none> <none> <none> operator <none> <none> <none> <none> <none> <none> name lightest <none> <none> <none>
go to the kitchen to find the noodles 	_ bring noodles <none> <none> <none> <none> kitchen operator <none> <none> <none> <none> <none> <none> <none> <none> <none> <none> <none>
Get me the shampoo from the bookshelf 	_ bring shampoo in bookshelf <none> <none> <none> operator <none> <none> <none> <none> <none> <none> <none> <none> <none> <none> <none>
Give me a tray from the dining table. 	_ bring tray in table <none> <none> dining_room operator <none> <none> <none> <none> <none> <none> <none> <none> <none> <none> <none>
how many cokes are left in the freezer 	_ find coke in fridge <none> <none> <none> operator <none> <none> <none> <none> <none> <none> count <none> <none> <none> <none>
Please meet Morgan to guide her, Robot 	_ guide Morgan <none> <none> <none> <none> <none> <none> <none> <none> <none> <none> <none> <none> <none> <none> <none> <none> <none>
How many objects are on the bookshelf? 	_ find object on bookshelf <none> <none> <none> operator <none> <none> <none> <none> <none> <none> count <none> <none> <none> <none>
How many things are there on the sink? 	_ find object on sink <none> <none> <none> operator <none> <none> <none> <none> <none> <none> count <none> <none> <none> <none>
What is the heaviest thing on the sofa? 	_ find object on sofa <none> <none> <none> operator <none> <none> <none> <none> <none> <none> name heaviest <none> <none> <none>
Could I please have that pasta, Robot? 	_ bring pasta <none> <none> <none> <none> <none> operator <none> <none> <none> <none> <none> <none> <none> <none> <none> <none> <none>
what is the lightest object on the bar 	_ find object on bar <none> <none> <none> operator <none> <none> <none> <none> <none> <none> name lightest <none> <none> <none>
look for three objects in the bathroom 	_ bring object <none> <none> <none> <none> bathroom operator <none> <none> <none> <none> <none> <none> <none> <none> 3 <none> <none>
What is the largest thing on the shower 	_ find object on shower <none> <none> <none> operator <none> <none> <none> <none> <none> <none> name largest <none> <none> <none>
Find the man in the bedroom 	_ guide male <none> <none> <none> <none> bedroom operator <none> <none> <none> <none> <none> <none> name <none> <none> <none> <none>
Get a bowl. 	_ bring bowl <none> <none> <none> <none> <none> operator <none> <none> <none> <none> <none> <none> <none> <none> <none> <none> <none>
put some cereals in it 	_ bring cereal <none> <none> <none> <none> <none> place in <none> <none> <none> <none> <none> <none> <none> <none> <none> <none>
Please pour some cereal into the bowl. 	_ bring cereal <none> <none> <none> <none> <none> place in bowl <none> <none> <none> <none> <none> <none> <none> <none> <none>
Please move the milk onto the wardrobe 	_ bring milk <none> <none> <none> <none> <none> place on wardrobe <none> <none> <none> <none> <none> <none> <none> <none> <none>
Put the cereal in the bathroom cabinet 	_ bring cereal <none> <none> <none> <none> <none> place on cabinet <none> <none> bathroom <none> <none> <none> <none> <none> <none>
Put the small dish on the dining table 	_ bring dish <none> <none> <none> <none> <none> place on table <none> <none> dining_room <none> <none> smallest <none> <none> <none>
The tea goes on the dining room table. 	_ bring tea <none> <none> <none> <none> <none> place on table <none> <none> dining_room <none> <none> <none> <none> <none> <none>
put the apple on the side of the table 	_ bring apple <none> <none> <none> <none> <none> place on table <none> <none> <none> <none> <none> <none> <none> <none> <none>
what is the lightest thing on the desk 	_ find object on desk <none> <none> <none> operator <none> <none> <none> <none> <none> <none> name lightest <none> <none> <none>
Go to the bathroom. 	_ go <none> <none> <none> <none> <none> bathroom <none> <none> <none> <none> <none> <none> <none> <none> <none> <none> <none> <none>
find the peach 	_ bring peach <none> <none> <none> <none> <none> operator <none> <none> <none> <none> <none> <none> <none> <none> <none> <none> <none>
find the noodles 	_ bring noodles <none> <none> <none> <none> <none> operator <none> <none> <none> <none> <none> <none> <none> <none> <none> <none> <none>
Follow the objects on the coffee table 	_ follow person <none> <none> <none> <none> <none> <none> <none> <none> <none> <none> <none> <none> <none> <none> <none> <none> <none>
Go look for the things in the bathroom. 	_ bring object <none> <none> <none> <none> bathroom operator <none> <none> <none> <none> <none> <none> <none> <none> <none> <none> <none>
find the objects 	_ bring object <none> <none> <none> <none> <none> operator <none> <none> <none> <none> <none> <none> <none> <none> <none> <none> <none>
Take Robin from center table to toilet. 	_ guide Robin at table <none> <none> <none> place at toilet <none> <none> <none> <none> <none> <none> <none> <none> <none>
Go to the bedroom 	_ go <none> <none> <none> <none> <none> bedroom <none> <none> <none> <none> <none> <none> <none> <none> <none> <none> <none> <none>
At the baby chair bring Jordan the soap 	_ bring soap <none> <none> <none> <none> <none> Jordan at chair <none> <none> <none> <none> <none> <none> <none> <none> <none>
What is the smalled thing in the fridge? 	_ find object in fridge <none> <none> <none> operator <none> <none> <none> <none> <none> <none> name smallest <none> <none> <none>
Bring me the biggest things in the sink 	_ bring object in sink <none> <none> <none> operator <none> <none> <none> <none> <none> <none> <none> largest <none> <none> <none>
Find Morgan in the toilet. 	_ guide Morgan in toilet <none> <none> <none> operator <none> <none> <none> <none> <none> <none> <none> <none> <none> <none> <none>
I'd like some cereal in the bowl please 	_ bring cereal <none> <none> <none> <none> <none> place in bowl <none> <none> <none> <none> <none> <none> <none> <none> <none>
take this milk to the dining room table 	_ bring milk <none> <none> <none> <none> <none> place on table <none> <none> dining_room <none> <none> <none> <none> <none> <none>
Kindly get me the object under the milk 	_ bring object under milk <none> <none> <none> operator <none> <none> <none> <none> <none> <none> <none> <none> <none> <none> <none>
Please bring Hayden over to the freezer 	_ guide Hayden <none> <none> <none> <none> <none> place at fridge <none> <none> <none> <none> <none> <none> <none> <none> <none>
What are the flimsiest items on the bar 	_ find object on bar <none> <none> <none> operator <none> <none> <none> <none> <none> <none> name thinnest <none> <none> <none>
Can you bring me cookies from the sink? 	_ bring cookies in sink <none> <none> <none> operator <none> <none> <none> <none> <none> <none> <none> <none> <none> <none> <none>
get me the beer that is on the tv couch 	_ bring beer on couch <none> <none> <none> operator <none> <none> <none> <none> <none> <none> <none> <none> <none> <none> <none>
get the chocoflake out of the freezer 	_ bring chocoflake out fridge <none> <none> <none> operator <none> <none> <none> <none> <none> <none> <none> <none> <none> <none> <none>
give me the pear that is on the dresser 	_ bring pear on dresser <none> <none> <none> operator <none> <none> <none> <none> <none> <none> <none> <none> <none> <none> <none>
What pose is the person in the bathroom 	_ find person <none> <none> <none> <none> bathroom operator <none> <none> <none> <none> <none> <none> guesture <none> <none> <none> <none>
Tell me the number of trays in the fridge 	_ find tray in fridge <none> <none> <none> operator <none> <none> <none> <none> <none> <none> count <none> <none> <none> <none>
How many items are there on that drawer? 	_ find object on drawer <none> <none> <none> operator <none> <none> <none> <none> <none> <none> count <none> <none> <none> <none>
Take Hayden from the bar to the cabinet. 	_ guide Hayden at bar <none> <none> <none> place at cabinet <none> <none> <none> <none> <none> <none> <none> <none> <none>
Find the woman in the kitchen 	_ guide female <none> <none> <none> <none> kitchen operator <none> <none> <none> <none> <none> <none> <none> <none> <none> <none> <none>
What is the heaviest thing on the couch? 	_ find object on couch <none> <none> <none> operator <none> <none> <none> <none> <none> <none> name heaviest <none> <none> <none>
The chocoflake need to be given to me. 	_ bring chocoflake <none> <none> <none> <none> <none> operator <none> <none> <none> <none> <none> <none> <none> <none> <none> <none> <none>
On the bar, which item weighs the least? 	_ find object on bar <none> <none> <none> operator <none> <none> <none> <none> <none> <none> name lightest <none> <none> <none>
whats the lightest thing in the cupboard 	_ find object in cupboard <none> <none> <none> operator <none> <none> <none> <none> <none> <none> name lightest <none> <none> <none>
Say a joke the person in the living room 	_ answer person <none> <none> <none> <none> living_room <none> <none> <none> <none> <none> <none> joke <none> <none> <none> <none> <none>
Tell a person in the dining room a joke. 	_ answer person <none> <none> <none> <none> dining_room <none> <none> <none> <none> <none> <none> joke <none> <none> <none> <none> <none>
I need the larges object from the toilet 	_ bring object in toilet <none> <none> <none> operator <none> <none> <none> <none> <none> <none> <none> largest <none> <none> <none>
What is the heaviest object on the desk? 	_ find object on desk <none> <none> <none> operator <none> <none> <none> <none> <none> <none> name heaviest <none> <none> <none>
Whats the heaviest object in the fridge? 	_ find object in fridge <none> <none> <none> operator <none> <none> <none> <none> <none> <none> name heaviest <none> <none> <none>
what are the heaviest things in the sink 	_ find object in sink <none> <none> <none> operator <none> <none> <none> <none> <none> <none> name heaviest <none> <none> <none>
take the bag from the cabinet to the bar 	_ bring bag in cabinet <none> <none> <none> place on bar <none> <none> <none> <none> <none> <none> <none> <none> <none>
What is the smallest object in the fridge 	_ find object in fridge <none> <none> <none> operator <none> <none> <none> <none> <none> <none> name smallest <none> <none> <none>
Go to the bar 	_ go <none> at bar <none> <none> <none> <none> <none> <none> <none> <none> <none> <none> <none> <none> <none> <none> <none>
find Hayden 	_ guide Hayden <none> <none> <none> <none> <none> operator <none> <none> <none> <none> <none> <none> <none> <none> <none> <none> <none>
take him 	_ guide male <none> <none> <none> <none> <none> <none> <none> <none> <none> <none> <none> <none> <none> <none> <none> <none> <none>
Bring the chocoflake to the fireplace. 	_ bring chocoflake <none> <none> <none> <none> <none> place on fireplace <none> <none> <none> <none> <none> <none> <none> <none> <none>
set it on the counter 	_ bring object <none> <none> <none> <none> <none> place on counter <none> <none> <none> <none> <none> <none> <none> <none> <none>
set the cup on the desk 	_ bring cup <none> <none> <none> <none> <none> place on desk <none> <none> <none> <none> <none> <none> <none> <none> <none>
Grab the apple 	_ bring apple <none> <none> <none> <none> <none> <none> <none> <none> <none> <none> <none> <none> <none> <none> <none> <none> <none>
Grab the peach 	_ bring peach <none> <none> <none> <none> <none> <none> <none> <none> <none> <none> <none> <none> <none> <none> <none> <none> <none>
Move the cereal to the bathroom cabinet 	_ bring cereal <none> <none> <none> <none> <none> place on cabinet <none> <none> bathroom <none> <none> <none> <none> <none> <none>
Put the cereal into the bathroom cabinet 	_ bring cereal <none> <none> <none> <none> <none> place on cabinet <none> <none> <none> <none> <none> <none> <none> <none> <none>
Take the small dish to the dining table. 	_ bring dish <none> <none> <none> <none> <none> place on table <none> <none> dining_room <none> <none> smallest <none> <none> <none>
What objects on the bar weigh the least? 	_ find object on bar <none> <none> <none> operator <none> <none> <none> <none> <none> <none> name lightest <none> <none> <none>
In the kitchen, try to find the shampoo. 	_ bring shampoo <none> <none> <none> <none> kitchen operator <none> <none> <none> <none> <none> <none> <none> <none> <none> <none> <none>
can you find the glasses in the bathroom 	_ bring glass <none> <none> <none> <none> bathroom operator <none> <none> <none> <none> <none> <none> <none> <none> <none> <none> <none>
Bring me the chips on the dresser please 	_ bring chips on dresser <none> <none> <none> operator <none> <none> <none> <none> <none> <none> <none> <none> <none> <none> <none>
I want the chocoflake from the freezer 	_ bring chocoflake in fridge <none> <none> <none> operator <none> <none> <none> <none> <none> <none> <none> <none> <none> <none> <none>
bring me the chocoflake in the cabinet 	_ bring chocoflake in cabinet <none> <none> <none> operator <none> <none> <none> <none> <none> <none> <none> <none> <none> <none> <none>
tell Taylor a joke 	_ answer Taylor <none> <none> <none> <none> <none> <none> <none> <none> <none> <none> <none> joke <none> <none> <none> <none> <none>
How many people in the corridor are men? 	_ find male in corridor <none> <none> <none> operator <none> <none> <none> <none> <none> <none> count <none> <none> <none> <none>
How many beer are there on the baby chair 	_ find beer on chair <none> <none> <none> operator <none> <none> <none> <none> <none> <none> count <none> <none> <none> <none>
can you please find Morgan 	_ guide Morgan <none> <none> <none> <none> <none> operator <none> <none> <none> <none> <none> <none> <none> <none> <none> <none> <none>
What are the thinnest things on the sofa? 	_ find object on sofa <none> <none> <none> operator <none> <none> <none> <none> <none> <none> name thinnest <none> <none> <none>
find the three thinnest items on the sofa 	_ bring object on sofa <none> <none> <none> operator <none> <none> <none> <none> <none> <none> <none> thinnest 3 <none> <none>
bring the pickles for them. 	_ bring pickles <none> <none> <none> <none> <none> operator <none> <none> <none> <none> <none> <none> <none> <none> <none> <none> <none>
give it to Michael. 	_ bring object <none> <none> <none> <none> <none> Michael <none> <none> <none> <none> <none> <none> <none> <none> <none> <none> <none>
Take the big dish 	_ bring dish <none> <none> <none> <none> <none> operator <none> <none> <none> <none> <none> <none> <none> largest <none> <none> <none>
What is the heaviest object on the fridge 	_ find object on fridge <none> <none> <none> operator <none> <none> <none> <none> <none> <none> name heaviest <none> <none> <none>
What is the heaviest thing on the fridge? 	_ find object on fridge <none> <none> <none> operator <none> <none> <none> <none> <none> <none> name heaviest <none> <none> <none>
what is the heaviest item on the wardrobe 	_ find object on wardrobe <none> <none> <none> operator <none> <none> <none> <none> <none> <none> name heaviest <none> <none> <none>
Locate the toothpaste. 	_ bring toothpaste <none> <none> <none> <none> <none> operator <none> <none> <none> <none> <none> <none> <none> <none> <none> <none> <none>
Pick up the tuna fish. 	_ bring tuna <none> <none> <none> <none> <none> operator <none> <none> <none> <none> <none> <none> <none> <none> <none> <none> <none>
What is the pose of the person at the bath 	_ find person at <none> <none> <none> bathroom operator <none> <none> <none> <none> <none> <none> guesture <none> <none> <none> <none>
Please find three objects in this bedroom 	_ bring object <none> <none> <none> <none> bedroom operator <none> <none> <none> <none> <none> <none> <none> <none> 3 <none> <none>
Say a joke to someone in the living room. 	_ answer person <none> <none> <none> <none> living_room <none> <none> <none> <none> <none> <none> joke <none> <none> <none> <none> <none>
Tell a joke to the person in the kitchen. 	_ answer person <none> <none> <none> <none> kitchen <none> <none> <none> <none> <none> <none> joke <none> <none> <none> <none> <none>
Give Hayden the shampoo in the baby chair 	_ bring shampoo in chair <none> <none> <none> Hayden <none> <none> <none> <none> <none> <none> <none> <none> <none> <none> <none>
What is the biggest object in the shower? 	_ find object in shower <none> <none> <none> operator <none> <none> <none> <none> <none> <none> name largest <none> <none> <none>
guide Jamie from the cabinet back to here 	_ guide Jamie at cabinet <none> <none> <none> operator <none> <none> <none> <none> <none> <none> <none> <none> <none> <none> <none>
meet robin at the counter escort her back 	_ follow Robin at counter <none> <none> <none> operator <none> <none> <none> <none> <none> <none> <none> <none> <none> <none> <none>
escort them 	_ follow person <none> <none> <none> <none> <none> <none> <none> <none> <none> <none> <none> <none> <none> <none> <none> <none> <none>
meet Morgan at the drawer 	_ find Morgan at drawer <none> <none> <none> <none> <none> <none> <none> <none> <none> <none> <none> <none> <none> <none> <none>
bring it to the desk. 	_ bring object <none> <none> <none> <none> <none> place on desk <none> <none> <none> <none> <none> <none> <none> <none> <none>
find the banana 	_ bring banana <none> <none> <none> <none> <none> operator <none> <none> <none> <none> <none> <none> <none> <none> <none> <none> <none>
bring the apple to the top of the counter 	_ bring apple <none> <none> <none> <none> <none> place on counter <none> <none> <none> <none> <none> <none> <none> <none> <none>
put the teaspoon on the bathroom cabinet 	_ bring teaspoon <none> <none> <none> <none> <none> place on cabinet <none> <none> bathroom <none> <none> <none> <none> <none> <none>
What is the thinnest item in the wardrobe. 	_ find object in wardrobe <none> <none> <none> operator <none> <none> <none> <none> <none> <none> name thinnest <none> <none> <none>
Which object on the sink is the thinnest? 	_ find object on sink <none> <none> <none> operator <none> <none> <none> <none> <none> <none> name thinnest <none> <none> <none>
What is the lightest objects on the desk? 	_ find object on desk <none> <none> <none> operator <none> <none> <none> <none> <none> <none> name lightest <none> <none> <none>
find the apple located in the dining room 	_ bring apple <none> <none> <none> <none> dining_room operator <none> <none> <none> <none> <none> <none> <none> <none> <none> <none> <none>
find me a knife 	_ bring knife <none> <none> <none> <none> <none> operator <none> <none> <none> <none> <none> <none> <none> <none> <none> <none> <none>
go to the living room 	_ go <none> <none> <none> <none> <none> living_room <none> <none> <none> <none> <none> <none> <none> <none> <none> <none> <none> <none>
what is the person in the bathroom doing? 	_ find person <none> <none> <none> <none> bathroom operator <none> <none> <none> <none> <none> <none> guesture <none> <none> <none> <none>
Find someone at the dining room 	_ guide person <none> <none> <none> <none> dining_room operator <none> <none> <none> <none> <none> <none> <none> <none> <none> <none> <none>
answer the question 	_ answer operator <none> <none> <none> <none> <none> <none> <none> <none> <none> <none> <none> <none> <none> <none> <none> <none> <none>
How many sponges are in the cutlery drawer 	_ find sponge in drawer <none> <none> <none> operator <none> <none> <none> <none> <none> <none> count <none> <none> <none> <none>
I need you to meet Morgan 	_ guide Morgan <none> <none> <none> <none> <none> operator <none> <none> <none> <none> <none> <none> <none> <none> <none> <none> <none>
can you meet morgan 	_ guide Morgan <none> <none> <none> <none> <none> operator <none> <none> <none> <none> <none> <none> <none> <none> <none> <none> <none>
can you find the key? 	_ bring key <none> <none> <none> <none> <none> operator <none> <none> <none> <none> <none> <none> <none> <none> <none> <none> <none>
show them the way 	_ guide person <none> <none> <none> <none> <none> <none> <none> <none> <none> <none> <none> <none> <none> <none> <none> <none> <none>
show him the way to living room 	_ guide male <none> <none> <none> <none> <none> <none> <none> <none> <none> <none> living_room <none> <none> <none> <none> <none> <none>
bring napkin to the person in the bathroom 	_ bring napkin <none> <none> <none> <none> <none> person <none> <none> <none> <none> bathroom <none> <none> <none> <none> <none> <none>
locate the objects. 	_ bring object <none> <none> <none> <none> <none> operator <none> <none> <none> <none> <none> <none> <none> <none> <none> <none> <none>
please find the objects in the dining room 	_ bring object <none> <none> <none> <none> dining_room operator <none> <none> <none> <none> <none> <none> <none> <none> <none> <none> <none>
Give me the biggest thing on the armchair. 	_ bring object on chair <none> <none> <none> operator <none> <none> <none> <none> <none> <none> <none> largest <none> <none> <none>
What item is the heaviest on the wardrobe? 	_ find object on wardrobe <none> <none> <none> operator <none> <none> <none> <none> <none> <none> name heaviest <none> <none> <none>
Which object on the couch weighs the most? 	_ find object on couch <none> <none> <none> operator <none> <none> <none> <none> <none> <none> name heaviest <none> <none> <none>
Please find three things from the bathroom 	_ bring object <none> <none> <none> <none> bathroom operator <none> <none> <none> <none> <none> <none> <none> <none> 3 <none> <none>
say the time to the person in the corridor 	_ answer person in corridor <none> <none> <none> <none> <none> <none> <none> <none> <none> time <none> <none> <none> <none> <none>
Give Jordan the knife from the dish washer 	_ bring knife in dishwasher <none> <none> <none> Jordan <none> <none> <none> <none> <none> <none> <none> <none> <none> <none> <none>
What are the heaviest objects in the sink? 	_ find object in sink <none> <none> <none> operator <none> <none> <none> <none> <none> <none> name heaviest <none> <none> <none>
relocate knife from bed to cutlery drawer. 	_ bring knife in bed <none> <none> <none> place on drawer <none> <none> <none> <none> <none> <none> <none> <none> <none>
Bring me the lightest objects on the sofa. 	_ bring object on sofa <none> <none> <none> operator <none> <none> <none> <none> <none> <none> <none> lightest <none> <none> <none>
bring me the lightest object from the wash 	_ bring object in washing_machine <none> <none> <none> operator <none> <none> <none> <none> <none> <none> <none> lightest <none> <none> <none>
What is the smallest object on the cabinet? 	_ find object on cabinet <none> <none> <none> operator <none> <none> <none> <none> <none> <none> name smallest <none> <none> <none>
put it on the side table 	_ bring object <none> <none> <none> <none> <none> place on table <none> <none> <none> <none> <none> <none> <none> <none> <none>
get the apple 	_ bring apple <none> <none> <none> <none> <none> operator <none> <none> <none> <none> <none> <none> <none> <none> <none> <none> <none>
Escort Michael until reaching the counter. 	_ follow Michael <none> <none> <none> <none> <none> place at counter <none> <none> <none> <none> <none> <none> <none> <none> <none>
Find the apple that is in the dining room. 	_ bring apple <none> <none> <none> <none> dining_room operator <none> <none> <none> <none> <none> <none> <none> <none> <none> <none> <none>
Please bring me cereal from the sofa there 	_ bring cereal in sofa <none> <none> <none> operator <none> <none> <none> <none> <none> <none> <none> <none> <none> <none> <none>
There is how many boys in the living room? 	_ find male <none> <none> <none> <none> living_room operator <none> <none> <none> <none> <none> <none> count <none> <none> <none> <none>
answer question. 	_ answer operator <none> <none> <none> <none> <none> <none> <none> <none> <none> <none> <none> <none> <none> <none> <none> <none> <none>
find person in the kitchen 	_ guide person <none> <none> <none> <none> kitchen operator <none> <none> <none> <none> <none> <none> <none> <none> <none> <none> <none>
Locate the person in the kitchen 	_ guide person <none> <none> <none> <none> kitchen <none> <none> <none> <none> <none> <none> <none> <none> <none> <none> <none> <none>
How many glasses are there on the cupboard? 	_ find glass on cupboard <none> <none> <none> operator <none> <none> <none> <none> <none> <none> count <none> <none> <none> <none>
How many melon are there on the dishwasher? 	_ find melon on dishwasher <none> <none> <none> operator <none> <none> <none> <none> <none> <none> count <none> <none> <none> <none>
what are the three biggest objects in sink? 	_ find object in sink <none> <none> <none> operator <none> <none> <none> <none> <none> <none> name largest 3 <none> <none>
Find the objects in the dining room please? 	_ bring object <none> <none> <none> <none> dining_room operator <none> <none> <none> <none> <none> <none> <none> <none> <none> <none> <none>
the shampoo could you bring it to me please 	_ bring shampoo <none> <none> <none> <none> <none> operator <none> <none> <none> <none> <none> <none> <none> <none> <none> <none> <none>
What item in the microwave weight the least 	_ find object in microwave <none> <none> <none> operator <none> <none> <none> <none> <none> <none> name lightest <none> <none> <none>
tell me who the person at the baby chair is 	_ find person at chair <none> <none> <none> operator <none> <none> <none> <none> <none> <none> name <none> <none> <none> <none>
Find three objects that are in the bedroom. 	_ bring object <none> <none> <none> <none> bedroom operator <none> <none> <none> <none> <none> <none> <none> <none> 3 <none> <none>
tell the time to the person on the bathroom 	_ answer person <none> <none> <none> <none> bathroom <none> <none> <none> <none> <none> <none> time <none> <none> <none> <none> <none>
Bring the big dish to Morgan by the freezer 	_ bring dish near fridge <none> <none> <none> Morgan <none> <none> <none> <none> <none> <none> <none> largest <none> <none> <none>
Which object on the fridge is the heaviest? 	_ find object on fridge <none> <none> <none> operator <none> <none> <none> <none> <none> <none> name heaviest <none> <none> <none>
Bring me the lightest objects from the sofa 	_ bring object in sofa <none> <none> <none> operator <none> <none> <none> <none> <none> <none> <none> lightest <none> <none> <none>
What is the smallest object on the counter? 	_ find object on counter <none> <none> <none> operator <none> <none> <none> <none> <none> <none> name smallest <none> <none> <none>
Please meet Hayden at the bar 	_ guide Hayden at bar <none> <none> <none> operator <none> <none> <none> <none> <none> <none> <none> <none> <none> <none> <none>
take them 	_ guide person <none> <none> <none> <none> <none> <none> <none> <none> <none> <none> <none> <none> <none> <none> <none> <none> <none>
what is the thinnest object in the wardrobe 	_ find object in wardrobe <none> <none> <none> operator <none> <none> <none> <none> <none> <none> name thinnest <none> <none> <none>
Can you find the glass inside the bathroom? 	_ bring glass <none> <none> <none> <none> bathroom operator <none> <none> <none> <none> <none> <none> <none> <none> <none> <none> <none>
find the coke. 	_ bring coke <none> <none> <none> <none> <none> operator <none> <none> <none> <none> <none> <none> <none> <none> <none> <none> <none>
please go to the bedroom 	_ go <none> <none> <none> <none> <none> bedroom <none> <none> <none> <none> <none> <none> <none> <none> <none> <none> <none> <none>
Please locate the spaghetti in the bathroom 	_ bring pasta <none> <none> <none> <none> bathroom operator <none> <none> <none> <none> <none> <none> <none> <none> <none> <none> <none>
What is the thinnest item in the dishwasher 	_ find object in dishwasher <none> <none> <none> operator <none> <none> <none> <none> <none> <none> name thinnest <none> <none> <none>
Bring me the bowl that is on the baby chair 	_ bring bowl on chair <none> <none> <none> operator <none> <none> <none> <none> <none> <none> <none> <none> <none> <none> <none>
Bring me the chips that are on the dresser. 	_ bring chips on dresser <none> <none> <none> operator <none> <none> <none> <none> <none> <none> <none> <none> <none> <none> <none>
Get me a teaspoon from the cutlery drawer. 	_ bring teaspoon in drawer <none> <none> <none> operator <none> <none> <none> <none> <none> <none> <none> <none> <none> <none> <none>
Go to the tv couch. 	_ go <none> at couch <none> <none> <none> <none> <none> <none> <none> <none> <none> <none> <none> <none> <none> <none> <none>
get the beer for me 	_ bring beer <none> <none> <none> <none> <none> operator <none> <none> <none> <none> <none> <none> <none> <none> <none> <none> <none>
what items are the largest on the microwave 	_ find object on microwave <none> <none> <none> operator <none> <none> <none> <none> <none> <none> name largest <none> <none> <none>
how many people in the living room are male? 	_ find male <none> <none> <none> <none> living_room operator <none> <none> <none> <none> <none> <none> count <none> <none> <none> <none>
How is the person in the bathroom standing? 	_ find person <none> <none> <none> <none> bathroom operator <none> <none> <none> <none> <none> <none> guesture <none> <none> <none> <none>
how many melons are there in the dishwasher? 	_ find melon in dishwasher <none> <none> <none> operator <none> <none> <none> <none> <none> <none> count <none> <none> <none> <none>
What are the skinniest objects on the couch? 	_ find object on couch <none> <none> <none> operator <none> <none> <none> <none> <none> <none> name thinnest <none> <none> <none>
look for the items 	_ bring object <none> <none> <none> <none> <none> operator <none> <none> <none> <none> <none> <none> <none> <none> <none> <none> <none>
look for my key 	_ bring key <none> <none> <none> <none> <none> operator <none> <none> <none> <none> <none> <none> <none> <none> <none> <none> <none>
How many objects are there on the baby chair 	_ find object on chair <none> <none> <none> operator <none> <none> <none> <none> <none> <none> count <none> <none> <none> <none>
Locate girl in bathroom. 	_ guide female <none> <none> <none> <none> bathroom operator <none> <none> <none> <none> <none> <none> <none> <none> <none> <none> <none>
I need you to retrieve the tuna fish for me. 	_ bring tuna <none> <none> <none> <none> <none> operator <none> <none> <none> <none> <none> <none> <none> <none> <none> <none> <none>
What is the lightest object on the cupboard? 	_ find object on cupboard <none> <none> <none> operator <none> <none> <none> <none> <none> <none> name lightest <none> <none> <none>
Take a teaspoon to Jordan at the nightstand 	_ bring teaspoon <none> <none> <none> <none> <none> Jordan at nightstand <none> <none> <none> <none> <none> <none> <none> <none> <none>
give the pickles at the baby chair to Taylor 	_ bring pickles at chair <none> <none> <none> Taylor <none> <none> <none> <none> <none> <none> <none> <none> <none> <none> <none>
Bring me the biggest thing from the cabinet. 	_ bring object in cabinet <none> <none> <none> operator <none> <none> <none> <none> <none> <none> <none> largest <none> <none> <none>
Get the biggest item from the cabinet for me 	_ bring object in cabinet <none> <none> <none> operator <none> <none> <none> <none> <none> <none> <none> largest <none> <none> <none>
bring me the biggest thing from the bathroom 	_ bring object <none> <none> <none> <none> bathroom operator <none> <none> <none> <none> <none> <none> <none> largest <none> <none> <none>
What is the smallest objects on the freezer? 	_ find object on fridge <none> <none> <none> operator <none> <none> <none> <none> <none> <none> name smallest <none> <none> <none>
Can you please pour some cereal into my bowl 	_ bring cereal <none> <none> <none> <none> <none> place in bowl <none> <none> <none> <none> <none> <none> <none> <none> <none>
take it to the shower. 	_ bring object <none> <none> <none> <none> <none> place on shower <none> <none> <none> <none> <none> <none> <none> <none> <none>
Please take that melon to that coffee table 	_ bring melon <none> <none> <none> <none> <none> place on table <none> <none> <none> <none> <none> <none> <none> <none> <none>
put the milk on the table in the dining room 	_ bring milk <none> <none> <none> <none> <none> place on table <none> <none> dining_room <none> <none> <none> <none> <none> <none>
answer a persons question 	_ answer person <none> <none> <none> <none> <none> <none> <none> <none> <none> <none> <none> <none> <none> <none> <none> <none> <none>
Which object is the least heavy on the sofa? 	_ find object on sofa <none> <none> <none> operator <none> <none> <none> <none> <none> <none> name lightest <none> <none> <none>
Can you go to the corridor? 	_ go <none> at corridor <none> <none> <none> <none> <none> <none> <none> <none> <none> <none> <none> <none> <none> <none> <none>
What is the thinnest object in the cupboard? 	_ find object in cupboard <none> <none> <none> operator <none> <none> <none> <none> <none> <none> name thinnest <none> <none> <none>
What is the thinnest thing on this cupboard? 	_ find object on cupboard <none> <none> <none> operator <none> <none> <none> <none> <none> <none> name thinnest <none> <none> <none>
what is the skinniest thing in the cupboard? 	_ find object in cupboard <none> <none> <none> operator <none> <none> <none> <none> <none> <none> name thinnest <none> <none> <none>
pass me the pasta from the nightstand please 	_ bring pasta in nightstand <none> <none> <none> operator <none> <none> <none> <none> <none> <none> <none> <none> <none> <none> <none>
tell Morgan a joke 	_ answer Morgan <none> <none> <none> <none> <none> <none> <none> <none> <none> <none> <none> joke <none> <none> <none> <none> <none>
Tell Tracy what day it is in the living room 	_ answer Tracy <none> <none> <none> <none> living_room <none> <none> <none> <none> <none> <none> date <none> <none> <none> <none> <none>
go tell Tracy in the bathroom about yourself 	_ answer Tracy <none> <none> <none> <none> bathroom <none> <none> <none> <none> <none> <none> yourself <none> <none> <none> <none> <none>
Bring the objects in the shower to the stove 	_ bring object in shower <none> <none> <none> place on stove <none> <none> <none> <none> <none> <none> <none> <none> <none>
Meet the apple at the counter. 	_ bring apple on counter <none> <none> <none> operator <none> <none> <none> <none> <none> <none> <none> <none> <none> <none> <none>
How many males are there in the dining room? 	_ find male <none> <none> <none> <none> dining_room operator <none> <none> <none> <none> <none> <none> count <none> <none> <none> <none>
What pose is that guy in the corridor doing. 	_ find male in corridor <none> <none> <none> operator <none> <none> <none> <none> <none> <none> guesture <none> <none> <none> <none>
What are three most thing on that desk there? 	_ find object on desk <none> <none> <none> operator <none> <none> <none> <none> <none> <none> name most 3 <none> <none>
what are the three thinnest items in the sink 	_ find object in sink <none> <none> <none> operator <none> <none> <none> <none> <none> <none> name thinnest 3 <none> <none>
Tell me where the objects in the bathroom are 	_ find object <none> <none> <none> <none> bathroom operator <none> <none> <none> <none> <none> <none> where <none> <none> <none> <none>
State the number of items on the center table 	_ find object on table <none> <none> <none> operator <none> <none> <none> <none> <none> <none> count <none> <none> <none> <none>
Answer the question of a girl in the bedroom. 	_ answer female <none> <none> <none> <none> bedroom <none> <none> <none> <none> <none> <none> <none> <none> <none> <none> <none> <none>
get me the largest object on the coffee table 	_ bring object on table <none> <none> <none> operator <none> <none> <none> <none> <none> <none> <none> largest <none> <none> <none>
what is the person's name in the living room? 	_ find person <none> <none> <none> <none> living_room operator <none> <none> <none> <none> <none> <none> name <none> <none> <none> <none>
please look for three objects in the bathroom 	_ bring object <none> <none> <none> <none> bathroom operator <none> <none> <none> <none> <none> <none> <none> <none> 3 <none> <none>
robot bring me three things from the bathroom 	_ bring object <none> <none> <none> <none> bathroom operator <none> <none> <none> <none> <none> <none> <none> <none> 3 <none> <none>
Take the tuna fish to Jamie by the microwave. 	_ bring tuna <none> <none> <none> <none> <none> Jamie at microwave <none> <none> <none> <none> <none> <none> <none> <none> <none>
meet robin 	_ guide Robin <none> <none> <none> <none> <none> operator <none> <none> <none> <none> <none> <none> <none> <none> <none> <none> <none>
escort him 	_ follow male <none> <none> <none> <none> <none> <none> <none> <none> <none> <none> <none> <none> <none> <none> <none> <none> <none>
Locate the tiniest objects inside the freezer 	_ find object in fridge <none> <none> <none> operator <none> <none> <none> <none> <none> <none> <none> thinnest <none> <none> <none>
what are the 3 biggest items on the fireplace 	_ find object on fireplace <none> <none> <none> operator <none> <none> <none> <none> <none> <none> name largest 3 <none> <none>
What is the smallest thing on the coffee table 	_ find object on table <none> <none> <none> operator <none> <none> <none> <none> <none> <none> name smallest <none> <none> <none>
Identify the thinnest object on the wardrobe. 	_ find object on microwave <none> <none> <none> operator <none> <none> <none> <none> <none> <none> name thinnest <none> <none> <none>
What is the thinnest thing on the dishwasher? 	_ find object on dishwasher <none> <none> <none> operator <none> <none> <none> <none> <none> <none> <none> thinnest <none> <none> <none>
Bring me the chocoflake out of the cabinet. 	_ bring chocoflake out cabinet <none> <none> <none> operator <none> <none> <none> <none> <none> <none> <none> <none> <none> <none> <none>
Tell Michael in the bathroom which day it is. 	_ answer Michael <none> <none> <none> <none> bathroom <none> <none> <none> <none> <none> <none> date <none> <none> <none> <none> <none>
Count the number of boys in the living room. 	_ find male <none> <none> <none> <none> living_room operator <none> <none> <none> <none> <none> <none> count <none> <none> <none> <none>
how many people are lying down in the bedroom 	_ find person <none> <none> <none> <none> bedroom operator <none> <none> <none> <none> <none> <none> count <none> <none> lying <none>
Bring the bag to the person in the dining room 	_ bring bag <none> <none> <none> <none> <none> person <none> <none> <none> <none> dining_room <none> <none> <none> <none> <none> <none>
Give chips to person in bedroom who is waving. 	_ bring chips <none> <none> <none> <none> <none> person <none> <none> <none> <none> bedroom <none> <none> <none> <none> waving <none>
Direct Peyton to the sink from the dishwasher. 	_ guide Peyton at dishwasher <none> <none> <none> place at sink <none> <none> <none> <none> <none> <none> <none> <none> <none>
Guide Jordan from the desk to the coffee table 	_ guide Jordan at desk <none> <none> <none> place at table <none> <none> <none> <none> <none> <none> <none> <none> <none>
Lead Jordan from the desk to the coffee table. 	_ guide Jordan at desk <none> <none> <none> place at table <none> <none> <none> <none> <none> <none> <none> <none> <none>
You may find Hayden at the cabinet in the bar. 	_ guide Hayden at cabinet <none> <none> <none> operator <none> <none> <none> <none> <none> <none> <none> <none> <none> <none> <none>
go with alex from the tv couch to the armchair 	_ follow Alex at couch <none> <none> <none> place at chair <none> <none> <none> <none> <none> <none> <none> <none> <none>
Answer a question for the girl in the bedroom. 	_ answer female <none> <none> <none> <none> bedroom <none> <none> <none> <none> <none> <none> <none> <none> <none> <none> <none> <none>
Give me the largest objects from the armchair. 	_ bring object in chair <none> <none> <none> operator <none> <none> <none> <none> <none> <none> <none> largest <none> <none> <none>
which object on that cupboard is the heaviest? 	_ find object on cupboard <none> <none> <none> operator <none> <none> <none> <none> <none> <none> name heaviest <none> <none> <none>
What is the pose of the person at the bathtub? 	_ find person at tub <none> <none> <none> operator <none> <none> <none> <none> <none> <none> guesture <none> <none> <none> <none>
what is the pose of the person at the armchair 	_ find person at chair <none> <none> <none> operator <none> <none> <none> <none> <none> <none> guesture <none> <none> <none> <none>
What object on the microwave weighs the least? 	_ find object on microwave <none> <none> <none> operator <none> <none> <none> <none> <none> <none> name lightest <none> <none> <none>
Find out the name of the person by the chair. 	_ find person at chair <none> <none> <none> operator <none> <none> <none> <none> <none> <none> name <none> <none> <none> <none>
What is the name of the person in the bedroom? 	_ find person <none> <none> <none> <none> bedroom operator <none> <none> <none> <none> <none> <none> name <none> <none> <none> <none>
What is the name of the person in the kitchen? 	_ find person <none> <none> <none> <none> kitchen operator <none> <none> <none> <none> <none> <none> name <none> <none> <none> <none>
what is the name of the person at the cabinet? 	_ find person at cabinet <none> <none> <none> operator <none> <none> <none> <none> <none> <none> name <none> <none> <none> <none>
LOOK FOR THREE OBJECTS IN THE BATHROOM PLEASE. 	_ bring object <none> <none> <none> <none> bathroom operator <none> <none> <none> <none> <none> <none> <none> <none> 3 <none> <none>
Bring Michael the cereal at the cutlery drawer 	_ bring cereal at drawer <none> <none> <none> Michael <none> <none> <none> <none> <none> <none> <none> <none> <none> <none> <none>
Whats the biggest thing on the cutlery drawer? 	_ find object on drawer <none> <none> <none> operator <none> <none> <none> <none> <none> <none> name largest <none> <none> <none>
Find Alex at the microwave 	_ guide Alex at microwave <none> <none> <none> operator <none> <none> <none> <none> <none> <none> <none> <none> <none> <none> <none>
bring her to here 	_ guide female <none> <none> <none> <none> <none> operator <none> <none> <none> <none> <none> <none> <none> <none> <none> <none> <none>
What are the smallest articles in the cabinet? 	_ find object in cabinet <none> <none> <none> operator <none> <none> <none> <none> <none> <none> name smallest <none> <none> <none>
answer a question for a boy in the dining room 	_ answer male <none> <none> <none> <none> dining_room <none> <none> <none> <none> <none> <none> <none> <none> <none> <none> <none> <none>
Hand me the lightest object on the towel rack. 	_ bring object on towel_rack <none> <none> <none> operator <none> <none> <none> <none> <none> <none> <none> lightest <none> <none> <none>
What are the three biggest objects on the tub? 	_ find object on tub <none> <none> <none> operator <none> <none> <none> <none> <none> <none> name largest 3 <none> <none>
Which are the three largest objects on the tub 	_ find object on tub <none> <none> <none> operator <none> <none> <none> <none> <none> <none> name largest 3 <none> <none>
What is the smallest item on the coffee table? 	_ find object on table <none> <none> <none> operator <none> <none> <none> <none> <none> <none> <none> smallest <none> <none> <none>
place the banana on it. 	_ bring banana <none> <none> <none> <none> <none> place on <none> <none> <none> <none> <none> <none> <none> <none> <none> <none>
take the cereal to the cabinet in the bathroom 	_ bring cereal <none> <none> <none> <none> <none> place on cabinet <none> <none> bathroom <none> <none> <none> <none> <none> <none>
Please show Jordan how to get to the cupboard. 	_ guide Jordan <none> <none> <none> <none> <none> place at cupboard <none> <none> <none> <none> <none> <none> <none> <none> <none>
Which item on the dishwasher weighs the least? 	_ find object on dishwasher <none> <none> <none> operator <none> <none> <none> <none> <none> <none> name lightest <none> <none> <none>
Follow the object that is at the center table. 	_ follow person at table <none> <none> <none> <none> <none> <none> <none> <none> <none> <none> <none> <none> <none> <none> <none>
Go to the toilet 	_ go <none> at toilet <none> <none> <none> <none> <none> <none> <none> <none> <none> <none> <none> <none> <none> <none> <none>
What pose is the person in the dining room in? 	_ find person <none> <none> <none> <none> dining_room operator <none> <none> <none> <none> <none> <none> guesture <none> <none> <none> <none>
Count the people lying down in the living room 	_ find person <none> <none> <none> <none> living_room operator <none> <none> <none> <none> <none> <none> count <none> <none> lying <none>
how many people are lying down in the corridor 	_ find person in corridor <none> <none> <none> operator <none> <none> <none> <none> <none> <none> count <none> <none> lying <none>
take him somewhere 	_ guide male <none> <none> <none> <none> <none> place at <none> <none> <none> <none> <none> <none> <none> <none> <none> <none>
Which three items on the desk are the thinnest? 	_ find object on desk <none> <none> <none> operator <none> <none> <none> <none> <none> <none> name thinnest 3 <none> <none>
Get me the object at the right of the chocolate 	_ bring object right chocolate <none> <none> <none> operator <none> <none> <none> <none> <none> <none> <none> <none> <none> <none> <none>
bing the big dish to the person in the corridor 	_ bring dish <none> <none> <none> <none> <none> person in corridor <none> <none> <none> <none> <none> largest <none> <none> <none>
Inform me of the number of items on the drawer. 	_ find object on drawer <none> <none> <none> operator <none> <none> <none> <none> <none> <none> count <none> <none> <none> <none>
Please take Alex to the shower from the drawer. 	_ guide Alex at drawer <none> <none> <none> place at shower <none> <none> <none> <none> <none> <none> <none> <none> <none>
Answer the question of the girl in the bedroom. 	_ answer female <none> <none> <none> <none> bedroom <none> <none> <none> <none> <none> <none> <none> <none> <none> <none> <none> <none>
Find female in dining room. 	_ guide female <none> <none> <none> <none> dining_room operator <none> <none> <none> <none> <none> <none> <none> <none> <none> <none> <none>
answer a question for the person in the kitchen 	_ answer person <none> <none> <none> <none> kitchen <none> <none> <none> <none> <none> <none> <none> <none> <none> <none> <none> <none>
Please me the weighty items from the towel rack 	_ bring object in towel_rack <none> <none> <none> operator <none> <none> <none> <none> <none> <none> <none> heaviest <none> <none> <none>
Go tell me what the lightest item on the bar is 	_ find object on bar <none> <none> <none> operator <none> <none> <none> <none> <none> <none> name lightest <none> <none> <none>
Go find three things in the dining room for me. 	_ bring object <none> <none> <none> <none> dining_room operator <none> <none> <none> <none> <none> <none> <none> <none> 3 <none> <none>
give the time. 	_ answer operator <none> <none> <none> <none> <none> <none> <none> <none> <none> <none> <none> time <none> <none> <none> <none> <none>
give your name 	_ answer operator <none> <none> <none> <none> <none> <none> <none> <none> <none> <none> <none> name <none> <none> <none> <none> <none>
tell your name 	_ answer operator <none> <none> <none> <none> <none> <none> <none> <none> <none> <none> <none> name <none> <none> <none> <none> <none>
Tell the person in the bedroom what time it is. 	_ answer person <none> <none> <none> <none> bedroom <none> <none> <none> <none> <none> <none> time <none> <none> <none> <none> <none>
Take this apple to Jordan at the cutlery drawer 	_ bring apple <none> <none> <none> <none> <none> Jordan at drawer <none> <none> <none> <none> <none> <none> <none> <none> <none>
What is the biggest item on the washing machine 	_ find object on washing_machine <none> <none> <none> operator <none> <none> <none> <none> <none> <none> name largest <none> <none> <none>
Answer the a boy's question in the dining room. 	_ answer male <none> <none> <none> <none> dining_room <none> <none> <none> <none> <none> <none> <none> <none> <none> <none> <none> <none>
Please bring me the lightest things on the sofa 	_ bring object on sofa <none> <none> <none> operator <none> <none> <none> <none> <none> <none> <none> lightest <none> <none> <none>
What are the heaviest items on the coffee table 	_ find object on table <none> <none> <none> operator <none> <none> <none> <none> <none> <none> name heaviest <none> <none> <none>
What are the three heaviest things on the chair 	_ find object on chair <none> <none> <none> operator <none> <none> <none> <none> <none> <none> name heaviest 3 <none> <none>
What is the smallest object on the center table? 	_ find object on table <none> <none> <none> operator <none> <none> <none> <none> <none> <none> name smallest <none> <none> <none>
escort her to me 	_ guide female <none> <none> <none> <none> <none> operator <none> <none> <none> <none> <none> <none> <none> <none> <none> <none> <none>
Robot, meet robin at side table. 	_ guide Robin at table <none> <none> <none> operator <none> <none> <none> <none> <none> <none> <none> <none> <none> <none> <none>
take this melon to the table in the living room 	_ bring melon <none> <none> <none> <none> <none> place on table <none> <none> living_room <none> <none> <none> <none> <none> <none>
take to the washing machine the flakes of choco 	_ bring chocoflake <none> <none> <none> <none> <none> place on washing_machine <none> <none> <none> <none> <none> <none> <none> <none> <none>
Which object is the lightest on the dishwasher? 	_ find object on dishwasher <none> <none> <none> operator <none> <none> <none> <none> <none> <none> name lightest <none> <none> <none>
On the fireplace, which items are the thinnest? 	_ find object on fireplace <none> <none> <none> operator <none> <none> <none> <none> <none> <none> name thinnest <none> <none> <none>
On the fireplace, which object is the thinnest? 	_ find object on fireplace <none> <none> <none> operator <none> <none> <none> <none> <none> <none> name thinnest <none> <none> <none>
What are the thinnest objects on the fireplace? 	_ find object on fireplace <none> <none> <none> operator <none> <none> <none> <none> <none> <none> name thinnest <none> <none> <none>
Get the cereal from the sofa. 	_ bring cereal in sofa <none> <none> <none> operator <none> <none> <none> <none> <none> <none> <none> <none> <none> <none> <none>
Go get me the beer on the couch in the tv room. 	_ bring beer on couch <none> <none> <none> operator <none> <none> <none> <none> <none> <none> <none> <none> <none> <none> <none>
Tell Michael, over at the stove, what day it is 	_ answer beer at stove <none> <none> <none> <none> <none> <none> <none> <none> <none> date <none> <none> <none> <none> <none>
Meet the shampoo on the tv couch. 	_ bring shampoo on couch <none> <none> <none> operator <none> <none> <none> <none> <none> <none> <none> <none> <none> <none> <none>
Please follow the apple that is on the counter. 	_ follow person on counter <none> <none> <none> <none> <none> <none> <none> <none> <none> <none> <none> <none> <none> <none> <none>
What are the three smallest objects on the sink 	_ find object on sink <none> <none> <none> operator <none> <none> <none> <none> <none> <none> name smallest 3 <none> <none>
What is the pose of the person in the bathroom? 	_ find person <none> <none> <none> <none> bathroom operator <none> <none> <none> <none> <none> <none> guesture <none> <none> <none> <none>
what is the pose of the person in the corridor? 	_ find person in corridor <none> <none> <none> operator <none> <none> <none> <none> <none> <none> guesture <none> <none> <none> <none>
How many teaspoons are on the nightstand please 	_ find teaspoon on nightstand <none> <none> <none> operator <none> <none> <none> <none> <none> <none> count <none> <none> <none> <none>
what are the three thinnest objects on the sink? 	_ find object on sink <none> <none> <none> operator <none> <none> <none> <none> <none> <none> name thinnest 3 <none> <none>
give the box to whoever is pointing to the right 	_ bring box <none> <none> <none> <none> <none> person <none> <none> <none> <none> <none> <none> <none> <none> <none> pointing_right <none>
Take Michael from the baby chair to the counter. 	_ guide Michael at chair <none> <none> <none> place at counter <none> <none> <none> <none> <none> <none> <none> <none> <none>
lead peyton to the sink 	_ guide Peyton <none> <none> <none> <none> <none> place at sink <none> <none> <none> <none> <none> <none> <none> <none> <none>
What pose is the person standing in the bathroom 	_ find person <none> <none> <none> <none> bathroom operator <none> <none> <none> <none> <none> <none> guesture <none> <none> <none> <none>
bring hayden the shampoo , hes in the baby chair 	_ bring shampoo <none> <none> <none> <none> <none> Hayden in chair <none> <none> <none> <none> <none> <none> <none> <none> <none>
Let me know what the largest item on the bar is. 	_ find object on bar <none> <none> <none> operator <none> <none> <none> <none> <none> <none> name largest <none> <none> <none>
what are the 3 least heavy items on the armchair 	_ find object on chair <none> <none> <none> operator <none> <none> <none> <none> <none> <none> name heaviest 3 <none> <none>
I want the largest things from the toilet please 	_ bring object in toilet <none> <none> <none> operator <none> <none> <none> <none> <none> <none> <none> largest <none> <none> <none>
Show me the heaviest objects placed on the sofa. 	_ bring object on sofa <none> <none> <none> operator <none> <none> <none> <none> <none> <none> <none> heaviest <none> <none> <none>
What is the heaviest thing in the fridge please? 	_ find object in fridge <none> <none> <none> operator <none> <none> <none> <none> <none> <none> name heaviest <none> <none> <none>
move the bag from the bookshelf to the side table 	_ bring bag in bookshelf <none> <none> <none> place at table <none> <none> <none> <none> <none> <none> <none> <none> <none>
What are the most small things on the fireplace? 	_ find object on fireplace <none> <none> <none> operator <none> <none> <none> <none> <none> <none> <none> smallest <none> <none> <none>
Get me the lightest object from the coffee table 	_ bring object in table <none> <none> <none> operator <none> <none> <none> <none> <none> <none> <none> lightest <none> <none> <none>
bring me the lightest item from the coffee table 	_ bring object in table <none> <none> <none> operator <none> <none> <none> <none> <none> <none> <none> lightest <none> <none> <none>
Lead Robin after meeting him from the side table 	_ guide Robin at table <none> <none> <none> <none> <none> <none> <none> <none> <none> <none> <none> <none> <none> <none> <none>
Retrieve the teaspoon 	_ bring teaspoon <none> <none> <none> <none> <none> operator <none> <none> <none> <none> <none> <none> <none> <none> <none> <none> <none>
Please locate the shampoo that is in the kitchen 	_ bring shampoo <none> <none> <none> <none> kitchen operator <none> <none> <none> <none> <none> <none> <none> <none> <none> <none> <none>
Please bring me that pear that is on the dresser 	_ bring pear on dresser <none> <none> <none> operator <none> <none> <none> <none> <none> <none> <none> <none> <none> <none> <none>
tell Michael what day it is. 	_ answer Michael <none> <none> <none> <none> <none> <none> <none> <none> <none> <none> <none> date <none> <none> <none> <none> <none>
follow the objects at the coffee table. 	_ follow person at table <none> <none> <none> <none> <none> <none> <none> <none> <none> <none> <none> <none> <none> <none> <none>
What are the three biggest things in the cabinet 	_ find object in cabinet <none> <none> <none> operator <none> <none> <none> <none> <none> <none> name largest 3 <none> <none>
Find the three smallest objects on the fireplace 	_ find object on fireplace <none> <none> <none> operator <none> <none> <none> <none> <none> <none> name smallest 3 <none> <none>
What are the smallest three objects on the sink? 	_ find object on sink <none> <none> <none> operator <none> <none> <none> <none> <none> <none> name smallest <none> <none> <none>
of the people in the corridor, how many are men? 	_ find male in corridor <none> <none> <none> operator <none> <none> <none> <none> <none> <none> count <none> <none> <none> <none>
Answer a question for the person in the bathroom. 	_ answer person <none> <none> <none> <none> bathroom <none> <none> <none> <none> <none> <none> <none> <none> <none> <none> <none> <none>
Find someone in the bathroom to answer a question 	_ answer person <none> <none> <none> <none> bathroom <none> <none> <none> <none> <none> <none> <none> <none> <none> <none> <none> <none>
find person 	_ guide person <none> <none> <none> <none> <none> operator <none> <none> <none> <none> <none> <none> <none> <none> <none> <none> <none>
answer a question 	_ answer operator <none> <none> <none> <none> <none> <none> <none> <none> <none> <none> <none> <none> <none> <none> <none> <none> <none>
Go with Jamie to the stove. They're on the couch. 	_ follow Jamie on couch <none> <none> <none> place at stove <none> <none> <none> <none> <none> <none> <none> <none> <none>
Help Jordan navigate from the dresser to the sofa 	_ guide Jordan at dresser <none> <none> <none> place at sofa <none> <none> <none> <none> <none> <none> <none> <none> <none>
Answer the question for the woman in the kitchen. 	_ answer female <none> <none> <none> <none> kitchen <none> <none> <none> <none> <none> <none> <none> <none> <none> <none> <none> <none>
Ask that person sitting in the kitchen a question 	_ ask person <none> <none> <none> <none> kitchen <none> <none> <none> <none> <none> <none> <none> <none> <none> <none> sitting <none>
Bring me the heaviest object on the coffee table. 	_ bring object on table <none> <none> <none> operator <none> <none> <none> <none> <none> <none> <none> heaviest <none> <none> <none>
Get me the heaviest objects from the coffee table 	_ bring object in table <none> <none> <none> operator <none> <none> <none> <none> <none> <none> <none> heaviest <none> <none> <none>
what are the three lightest objects inside fridge 	_ find object in fridge <none> <none> <none> operator <none> <none> <none> <none> <none> <none> name lightest 3 <none> <none>
Which three objects in the sink are the heaviest? 	_ find object in sink <none> <none> <none> operator <none> <none> <none> <none> <none> <none> name heaviest 3 <none> <none>
Locate three objects that are in the dining room. 	_ bring object <none> <none> <none> <none> dining_room operator <none> <none> <none> <none> <none> <none> <none> <none> 3 <none> <none>
say a joke 	_ answer operator <none> <none> <none> <none> <none> <none> <none> <none> <none> <none> <none> joke <none> <none> <none> <none> <none>
say your name 	_ answer operator <none> <none> <none> <none> <none> <none> <none> <none> <none> <none> <none> name <none> <none> <none> <none> <none>
tell the person in the living room what day it is 	_ answer person <none> <none> <none> <none> living_room <none> <none> <none> <none> <none> <none> date <none> <none> <none> <none> <none>
Take the cereal to Michael by the cutlery drawer. 	_ bring cereal <none> <none> <none> <none> <none> Michael at drawer <none> <none> <none> <none> <none> <none> <none> <none> <none>
On the bathroom cabinet, which object is largest? 	_ find object on cabinet <none> <none> bathroom operator <none> <none> <none> <none> <none> <none> name largest <none> <none> <none>
What is the biggest thing in the bathroom cabinet? 	_ find object in cabinet <none> <none> bathroom operator <none> <none> <none> <none> <none> <none> name largest <none> <none> <none>
Can you bring me the biggest thing on the counter 	_ bring object on counter <none> <none> <none> operator <none> <none> <none> <none> <none> <none> <none> largest <none> <none> <none>
Please hand me the biggest item from the cabinet. 	_ bring object in cabinet <none> <none> <none> operator <none> <none> <none> <none> <none> <none> <none> largest <none> <none> <none>
What are the heaviest objects in the sink please? 	_ find object in sink <none> <none> <none> operator <none> <none> <none> <none> <none> <none> <none> heaviest <none> <none> <none>
Move the bag from the bookshelf to the side table 	_ bring bag in bookshelf <none> <none> <none> place on table <none> <none> <none> <none> <none> <none> <none> <none> <none>
bring the peach to the bathtub from the microwave 	_ bring peach in microwave <none> <none> <none> place on tub <none> <none> <none> <none> <none> <none> <none> <none> <none>
bring the towel from the fridge over to the rack. 	_ bring towel in fridge <none> <none> <none> place on towel_rack <none> <none> <none> <none> <none> <none> <none> <none> <none>
What is are the smallest objects on the dishwasher 	_ find object on dishwasher <none> <none> <none> operator <none> <none> <none> <none> <none> <none> name smallest <none> <none> <none>
Answer the man in the bedroom who has a question. 	_ answer male <none> <none> <none> <none> bedroom <none> <none> <none> <none> <none> <none> <none> <none> <none> <none> <none> <none>
answer a question of a male person in the bedroom 	_ answer male <none> <none> <none> <none> bedroom <none> <none> <none> <none> <none> <none> <none> <none> <none> <none> <none> <none>
answer the question of the boy in the dining room 	_ answer male <none> <none> <none> <none> dining_room <none> <none> <none> <none> <none> <none> <none> <none> <none> <none> <none> <none>
What are the three largest items in the microwave 	_ find object in microwave <none> <none> <none> operator <none> <none> <none> <none> <none> <none> name largest 3 <none> <none>
find the smallest object on the cabinet 	_ guide object on cabinet <none> <none> <none> operator <none> <none> <none> <none> <none> <none> <none> smallest <none> <none> <none>
would you please pour some cereals into the bowl? 	_ bring cereal <none> <none> <none> <none> <none> place in bowl <none> <none> <none> <none> <none> <none> <none> <none> <none>
get the pickles 	_ bring pickles <none> <none> <none> <none> <none> operator <none> <none> <none> <none> <none> <none> <none> <none> <none> <none> <none>
bring them to the dishwasher. 	_ bring object <none> <none> <none> <none> <none> place on dishwasher <none> <none> <none> <none> <none> <none> <none> <none> <none>
Please give me the thinnest object on the drawer. 	_ bring object on drawer <none> <none> <none> operator <none> <none> <none> <none> <none> <none> <none> thinnest <none> <none> <none>
Robot, what is the thinnest object in the drawer? 	_ find object in drawer <none> <none> <none> operator <none> <none> <none> <none> <none> <none> name thinnest <none> <none> <none>
Please locate the mug that is in the dining room. 	_ bring mug <none> <none> <none> <none> dining_room operator <none> <none> <none> <none> <none> <none> <none> <none> <none> <none> <none>
A top the dishwasher, which item is the skinniest? 	_ find object top dishwasher <none> <none> <none> operator <none> <none> <none> <none> <none> <none> name thinnest <none> <none> <none>
get the milk 	_ bring milk <none> <none> <none> <none> <none> operator <none> <none> <none> <none> <none> <none> <none> <none> <none> <none> <none>
follow the milk 	_ follow person <none> <none> <none> <none> <none> <none> <none> <none> <none> <none> <none> <none> <none> <none> <none> <none> <none>
go with the objects from the shower to the stove. 	_ follow person at shower <none> <none> <none> place at stove <none> <none> <none> <none> <none> <none> <none> <none> <none>
What is the pose of the person in the dining room? 	_ find person <none> <none> <none> <none> dining_room operator <none> <none> <none> <none> <none> <none> guesture <none> <none> <none> <none>
Find the person waving from the kitchen 	_ guide person <none> <none> <none> <none> kitchen operator <none> <none> <none> <none> <none> <none> <none> <none> <none> waving <none>
Answer the question of the person in the bathroom. 	_ answer person <none> <none> <none> <none> bathroom <none> <none> <none> <none> <none> <none> <none> <none> <none> <none> <none> <none>
find someone in the bedroom 	_ guide person <none> <none> <none> <none> bedroom operator <none> <none> <none> <none> <none> <none> <none> <none> <none> <none> <none>
tell me the answer 	_ answer operator <none> <none> <none> <none> <none> <none> <none> <none> <none> <none> <none> <none> <none> <none> <none> <none> <none>
Tell me what the largest item on the bookshelf is. 	_ find object on bookshelf <none> <none> <none> operator <none> <none> <none> <none> <none> <none> name largest <none> <none> <none>
Which three objects on the sink are the skinniest? 	_ find object on sink <none> <none> <none> operator <none> <none> <none> <none> <none> <none> name thinnest 3 <none> <none>
get shampoo for the person raising their right arm 	_ bring shampoo <none> <none> <none> <none> <none> person <none> <none> <none> <none> <none> <none> <none> <none> <none> rising_right_arm <none>
Take Michael from the towel rack to the side table 	_ guide Michael at towel_rack <none> <none> <none> place at table <none> <none> <none> <none> <none> <none> <none> <none> <none>
go with Jamie who is at the tv couch to the stove. 	_ follow Jamie at couch <none> <none> <none> place at stove <none> <none> <none> <none> <none> <none> <none> <none> <none>
take Jamie from the dining table to the side table 	_ guide Jamie at table <none> <none> <none> place at table <none> <none> <none> <none> <none> <none> <none> <none> <none>
answer her question. 	_ answer male <none> <none> <none> <none> <none> <none> <none> <none> <none> <none> <none> <none> <none> <none> <none> <none> <none>
Bring me the heaviest objects from the towel rack. 	_ bring object in towel_rack <none> <none> <none> operator <none> <none> <none> <none> <none> <none> <none> heaviest <none> <none> <none>
I'd like the heaviest objects from the desk thanks 	_ bring object in desk <none> <none> <none> operator <none> <none> <none> <none> <none> <none> <none> heaviest <none> <none> <none>
Please bring me the heaviest objects from the desk 	_ bring object in desk <none> <none> <none> operator <none> <none> <none> <none> <none> <none> <none> heaviest <none> <none> <none>
In the sink, which three objects are the heaviest? 	_ find object in sink <none> <none> <none> operator <none> <none> <none> <none> <none> <none> name heaviest 3 <none> <none>
What is the lightest thing in the cupboard please? 	_ find object in cupboard <none> <none> <none> operator <none> <none> <none> <none> <none> <none> name lightest <none> <none> <none>
Let me know the name of whoever is in the kitchen. 	_ find person <none> <none> <none> <none> kitchen operator <none> <none> <none> <none> <none> <none> name <none> <none> <none> <none>
Say the time to the person you find in the bedroom 	_ answer person <none> <none> <none> <none> bedroom <none> <none> <none> <none> <none> <none> time <none> <none> <none> <none> <none>
Tell the person in the dining room what day it is. 	_ answer person <none> <none> <none> <none> dining_room <none> <none> <none> <none> <none> <none> date <none> <none> <none> <none> <none>
Go to the microwave to give the tuna fish to Jamie 	_ bring tuna <none> <none> <none> <none> <none> Jamie at microwave <none> <none> <none> <none> <none> <none> <none> <none> <none>
Hayden is at the baby chair, bring him the shampoo 	_ bring shampoo <none> <none> <none> <none> <none> Hayden at chair <none> <none> <none> <none> <none> <none> <none> <none> <none>
Take the cereal to Michael near the cutlery drawer 	_ bring cereal <none> <none> <none> <none> <none> Michael at drawer <none> <none> <none> <none> <none> <none> <none> <none> <none>
Which is the biggest object on the washing machine 	_ find object on washing_machine <none> <none> <none> operator <none> <none> <none> <none> <none> <none> name largest <none> <none> <none>
Bring the peach to the bathtub from the microwave. 	_ bring peach in microwave <none> <none> <none> place on tub <none> <none> <none> <none> <none> <none> <none> <none> <none>
What is the smallest thing on the washing machine? 	_ find object on washing_machine <none> <none> <none> operator <none> <none> <none> <none> <none> <none> name smallest <none> <none> <none>
A man in the kitchen has a question, go answer it. 	_ answer male <none> <none> <none> <none> kitchen <none> <none> <none> <none> <none> <none> <none> <none> <none> <none> <none> <none>
Find a guy in the bedroom 	_ guide male <none> <none> <none> <none> bedroom operator <none> <none> <none> <none> <none> <none> <none> <none> <none> <none> <none>
Hand me the lightest item from the washing machine 	_ bring object in washing_machine <none> <none> <none> operator <none> <none> <none> <none> <none> <none> <none> lightest <none> <none> <none>
bring me the lightest item off the washing machine 	_ bring object on washing_machine <none> <none> <none> operator <none> <none> <none> <none> <none> <none> <none> lightest <none> <none> <none>
Which are the three heaviest objects on the chair? 	_ find object on chair <none> <none> <none> operator <none> <none> <none> <none> <none> <none> name heaviest 3 <none> <none>
What are the three largest objects in the bathtub? 	_ find object in tub <none> <none> <none> operator <none> <none> <none> <none> <none> <none> name largest 3 <none> <none>
Robot which object is the smallest on the counter? 	_ find object on counter <none> <none> <none> operator <none> <none> <none> <none> <none> <none> name smallest <none> <none> <none>
Please fetch me that banana 	_ bring banana <none> <none> <none> <none> <none> operator <none> <none> <none> <none> <none> <none> <none> <none> <none> <none> <none>
Please take this banana 	_ bring banana <none> <none> <none> <none> <none> operator <none> <none> <none> <none> <none> <none> <none> <none> <none> <none> <none>
put it to the armchair 	_ bring object <none> <none> <none> <none> <none> place on chair <none> <none> <none> <none> <none> <none> <none> <none> <none>
Take the cookies. 	_ bring cookies <none> <none> <none> <none> <none> operator <none> <none> <none> <none> <none> <none> <none> <none> <none> <none> <none>
place them on the nightstand 	_ bring object <none> <none> <none> <none> <none> place on nightstand <none> <none> <none> <none> <none> <none> <none> <none> <none>
What is the thinnest thing in the bathroom cabinet 	_ find object in cabinet <none> <none> bathroom operator <none> <none> <none> <none> <none> <none> name thinnest <none> <none> <none>
what is the thinnest thing on the bathroom cabinet 	_ find object on cabinet <none> <none> bathroom operator <none> <none> <none> <none> <none> <none> name thinnest <none> <none> <none>
What are the lightest objects on this desk please? 	_ find object on desk <none> <none> <none> operator <none> <none> <none> <none> <none> <none> name lightest <none> <none> <none>
speak about yourself 	_ answer operator <none> <none> <none> <none> <none> <none> <none> <none> <none> <none> <none> yourself <none> <none> <none> <none> <none>
tell me about the three biggest objects on the bed 	_ find object on bed <none> <none> <none> operator <none> <none> <none> <none> <none> <none> name largest 3 <none> <none>
What is the pose of the person in the living room? 	_ find person <none> <none> <none> <none> living_room operator <none> <none> <none> <none> <none> <none> guesture <none> <none> <none> <none>
How many people are lying down in the dining room? 	_ find person <none> <none> <none> <none> dining_room operator <none> <none> <none> <none> <none> <none> count <none> <none> lying <none>
how many people are laying down in the living room 	_ find person <none> <none> <none> <none> living_room operator <none> <none> <none> <none> <none> <none> count <none> <none> lying <none>
answer the person lying down 	_ answer person <none> <none> <none> <none> <none> <none> <none> <none> <none> <none> <none> <none> <none> <none> <none> lying <none>
What is the number of cookies on the cutlery drawer? 	_ find cookies on drawer <none> <none> <none> operator <none> <none> <none> <none> <none> <none> count <none> <none> <none> <none>
What are the three biggest things on the microwave? 	_ find object on microwave <none> <none> <none> operator <none> <none> <none> <none> <none> <none> name largest 3 <none> <none>
Inform me of the three skinniest items on the desk. 	_ find object on desk <none> <none> <none> operator <none> <none> <none> <none> <none> <none> name thinnest 3 <none> <none>
Peyton is at the freezer follow them to the bedroom 	_ follow Peyton at fridge <none> <none> <none> place <none> <none> <none> <none> bedroom <none> <none> <none> <none> <none> <none>
show Peyton the way from the dishwasher to the sink 	_ guide Peyton at dishwasher <none> <none> <none> place at sink <none> <none> <none> <none> <none> <none> <none> <none> <none>
Go bring me the largest item from the coffee table. 	_ bring object in table <none> <none> <none> operator <none> <none> <none> <none> <none> <none> <none> largest <none> <none> <none>
Bring the heaviest objects on the towel rack to me. 	_ bring object on towel_rack <none> <none> <none> operator <none> <none> <none> <none> <none> <none> <none> heaviest <none> <none> <none>
Please locate three items that are in the bathroom. 	_ bring object <none> <none> <none> <none> bathroom operator <none> <none> <none> <none> <none> <none> <none> <none> 3 <none> <none>
tell someone about yourself in the kitchen 	_ answer person <none> <none> <none> <none> kitchen <none> <none> <none> <none> <none> <none> yourself <none> <none> <none> <none> <none>
Bring me the largest object you find in the cabinet 	_ bring object in cabinet <none> <none> <none> operator <none> <none> <none> <none> <none> <none> <none> largest <none> <none> <none>
disclose to me What is the heaviest item on the sofa 	_ find object on sofa <none> <none> <none> operator <none> <none> <none> <none> <none> <none> name heaviest <none> <none> <none>
Move the napkin from the nightstand to the cabinet. 	_ bring napkin in nightstand <none> <none> <none> place on cabinet <none> <none> <none> <none> <none> <none> <none> <none> <none>
On the nightstand there is a napkin, please take it 	_ bring napkin on nightstand <none> <none> <none> operator <none> <none> <none> <none> <none> <none> <none> <none> <none> <none> <none>
what is the smallest thing you see on the fireplace 	_ find object on fireplace <none> <none> <none> operator <none> <none> <none> <none> <none> <none> name smallest <none> <none> <none>
Answer the question for the boy in the living room. 	_ answer male <none> <none> <none> <none> living_room <none> <none> <none> <none> <none> <none> <none> <none> <none> <none> <none> <none>
LOCATE A MAN IN THE CORRIDOR. 	_ guide male in corridor <none> <none> <none> operator <none> <none> <none> <none> <none> <none> <none> <none> <none> <none> <none>
find a boy in the dining room 	_ guide male <none> <none> <none> <none> dining_room operator <none> <none> <none> <none> <none> <none> <none> <none> <none> <none> <none>
Go to freezer 	_ go <none> at fridge <none> <none> <none> <none> <none> <none> <none> <none> <none> <none> <none> <none> <none> <none> <none>
give me the lightest thing in it. 	_ bring object in <none> <none> <none> <none> operator <none> <none> <none> <none> <none> <none> <none> lightest <none> <none> <none>
I'd like the biggest objects on the TV couch thanks 	_ bring object on couch <none> <none> <none> operator <none> <none> <none> <none> <none> <none> <none> largest <none> <none> <none>
remind me what the smallest object on the toilet is 	_ find object on toilet <none> <none> <none> operator <none> <none> <none> <none> <none> <none> name smallest <none> <none> <none>
I would like for you to give the cereal to the tub. 	_ bring cereal <none> <none> <none> <none> <none> place on tub <none> <none> <none> <none> <none> <none> <none> <none> <none>
go to the dresser bring me what under the teaspoon 	_ bring object on dresser under teaspoon <none> operator <none> <none> <none> <none> <none> <none> <none> <none> <none> <none> <none>
Go in wardrobe 	_ go <none> in wardrobe <none> <none> <none> <none> <none> <none> <none> <none> <none> <none> <none> <none> <none> <none> <none>
take object behind cereal to me. 	_ bring object behind cereal <none> <none> <none> operator <none> <none> <none> <none> <none> <none> <none> <none> <none> <none> <none>
Let me know what the smallest item on the drawer is 	_ find object on drawer <none> <none> <none> operator <none> <none> <none> <none> <none> <none> name smallest <none> <none> <none>
Find the pickles near the desk 	_ bring pickles near desk <none> <none> <none> operator <none> <none> <none> <none> <none> <none> <none> <none> <none> <none> <none>
bring them to me 	_ bring object <none> <none> <none> <none> <none> operator <none> <none> <none> <none> <none> <none> <none> <none> <none> <none> <none>
Take the cookies from the sink 	_ bring cookies in sink <none> <none> <none> operator <none> <none> <none> <none> <none> <none> <none> <none> <none> <none> <none>
give them to me. 	_ bring object <none> <none> <none> <none> <none> operator <none> <none> <none> <none> <none> <none> <none> <none> <none> <none> <none>
Which are the three biggest objects on the cabinet? 	_ find object on cabinet <none> <none> <none> operator <none> <none> <none> <none> <none> <none> name largest <none> <none> <none>
what are the three smallest things on the fireplace 	_ find object on fireplace <none> <none> <none> operator <none> <none> <none> <none> <none> <none> name smallest 3 <none> <none>
tell me the person's pose 	_ find person <none> <none> <none> <none> <none> operator <none> <none> <none> <none> <none> <none> guesture <none> <none> <none> <none>
Answer a question of the person in the dining room. 	_ answer person <none> <none> <none> <none> dining_room <none> <none> <none> <none> <none> <none> <none> <none> <none> <none> <none> <none>
Locate someone in the bedroom. 	_ guide person <none> <none> <none> <none> bedroom operator <none> <none> <none> <none> <none> <none> <none> <none> <none> <none> <none>
Pick up the thing next to the pear on the bookshelf. 	_ bring object on bookshelf near pear <none> operator <none> <none> <none> <none> <none> <none> <none> <none> <none> <none> <none>
Can you please get the pickles 	_ bring pickles <none> <none> <none> <none> <none> operator <none> <none> <none> <none> <none> <none> <none> <none> <none> <none> <none>
give them to Alex 	_ bring object <none> <none> <none> <none> <none> Alex <none> <none> <none> <none> <none> <none> <none> <none> <none> <none> <none>
Bring Jamie from the dining table to the side table. 	_ guide Jamie at table <none> <none> <none> place at table <none> <none> <none> <none> <none> <none> <none> <none> <none>
Help Alex get from the drawer to the shower, please. 	_ guide Alex at drawer <none> <none> <none> place at shower <none> <none> <none> <none> <none> <none> <none> <none> <none>
find Tracy at he fridge 	_ guide Tracy at fridge <none> <none> <none> operator <none> <none> <none> <none> <none> <none> <none> <none> <none> <none> <none>
guide them to nightstand 	_ guide person <none> <none> <none> <none> <none> place at nightstand <none> <none> <none> <none> <none> <none> <none> <none> <none>
Answer the question for the girl in the dining room. 	_ answer female <none> <none> <none> <none> dining_room <none> <none> <none> <none> <none> <none> <none> <none> <none> <none> <none> <none>
Find the lady in the kitchen 	_ guide female <none> <none> <none> <none> kitchen operator <none> <none> <none> <none> <none> <none> <none> <none> <none> <none> <none>
answer her question 	_ answer female <none> <none> <none> <none> <none> <none> <none> <none> <none> <none> <none> <none> <none> <none> <none> <none> <none>
Go answer a question from a girl in the dining room. 	_ answer female <none> <none> <none> <none> dining_room <none> <none> <none> <none> <none> <none> <none> <none> <none> <none> <none> <none>
Go the the dining room 	_ go <none> <none> <none> <none> <none> dining_room <none> <none> <none> <none> <none> <none> <none> <none> <none> <none> <none> <none>
answer the girls question 	_ answer female <none> <none> <none> <none> <none> <none> <none> <none> <none> <none> <none> <none> <none> <none> <none> <none> <none>
Go to bedroom to locate a woman to answer a question 	_ answer female <none> <none> <none> <none> bedroom <none> <none> <none> <none> <none> <none> <none> <none> <none> <none> <none> <none>
Go to the side table 	_ go <none> at table <none> <none> <none> <none> <none> <none> <none> <none> <none> <none> <none> <none> <none> <none> <none>
bring me the largest items. 	_ bring object <none> <none> <none> <none> <none> operator <none> <none> <none> <none> <none> <none> <none> largest <none> <none> <none>
Please hand me the largest objects from the armchair 	_ bring object in chair <none> <none> <none> operator <none> <none> <none> <none> <none> <none> <none> largest <none> <none> <none>
Name an object that weighs the most in the wardrobe. 	_ find object in wardrobe <none> <none> <none> operator <none> <none> <none> <none> <none> <none> name heaviest <none> <none> <none>
bring me the heaviest objects from the coffee table. 	_ bring object in table <none> <none> <none> operator <none> <none> <none> <none> <none> <none> <none> heaviest <none> <none> <none>
go to the towel rack 	_ go <none> at towel_rack <none> <none> <none> <none> <none> <none> <none> <none> <none> <none> <none> <none> <none> <none> <none>
tell me your name 	_ answer operator <none> <none> <none> <none> <none> <none> <none> <none> <none> <none> <none> name <none> <none> <none> <none> <none>
tell me his name 	_ find male <none> <none> <none> <none> <none> operator <none> <none> <none> <none> <none> <none> name <none> <none> <none> <none>
tell me her name 	_ find female <none> <none> <none> <none> <none> operator <none> <none> <none> <none> <none> <none> name <none> <none> <none> <none>
bring me the heaviest thing 	_ bring object <none> <none> <none> <none> <none> operator <none> <none> <none> <none> <none> <none> <none> heaviest <none> <none> <none>
Which are the three lightest objects on the counter? 	_ find object on counter <none> <none> <none> operator <none> <none> <none> <none> <none> <none> name lightest 3 <none> <none>
On the cutlery drawer, which item weights the least? 	_ find object on drawer <none> <none> <none> operator <none> <none> <none> <none> <none> <none> name lightest <none> <none> <none>
Find the person at the chair 	_ guide person at chair <none> <none> <none> operator <none> <none> <none> <none> <none> <none> <none> <none> <none> <none> <none>
tell me their name. 	_ find person <none> <none> <none> <none> <none> operator <none> <none> <none> <none> <none> <none> name <none> <none> <none> <none>
The person in the kitchen please tell me their name. 	_ find person <none> <none> <none> <none> kitchen operator <none> <none> <none> <none> <none> <none> name <none> <none> <none> <none>
Say the current week day to a person in the bedroom. 	_ answer person <none> <none> <none> <none> bedroom <none> <none> <none> <none> <none> <none> day_of_week <none> <none> <none> <none> <none>
find way to corridor 	_ go <none> at corridor <none> <none> <none> <none> <none> <none> <none> <none> <none> <none> <none> <none> <none> <none> <none>
find a person 	_ guide person <none> <none> <none> <none> <none> operator <none> <none> <none> <none> <none> <none> <none> <none> <none> <none> <none>
tell the day 	_ answer operator <none> <none> <none> <none> <none> <none> <none> <none> <none> <none> <none> date <none> <none> <none> <none> <none>
Go to the cupboard with michael 	_ guide Michael <none> <none> <none> <none> <none> place at cupboard <none> <none> <none> <none> <none> <none> <none> <none> <none>
follow him back. 	_ follow male <none> <none> <none> <none> <none> <none> <none> <none> <none> <none> <none> <none> <none> <none> <none> <none> <none>
What are the three lightest objects on the armchair? 	_ find object on chair <none> <none> <none> operator <none> <none> <none> <none> <none> <none> name lightest 3 <none> <none>
what are the smallest objects objects on the fridge? 	_ find object on fridge <none> <none> <none> operator <none> <none> <none> <none> <none> <none> name smallest <none> <none> <none>
Find the male in the bedroom 	_ guide male <none> <none> <none> <none> bedroom operator <none> <none> <none> <none> <none> <none> <none> <none> <none> <none> <none>
ask him a question. 	_ ask male <none> <none> <none> <none> <none> <none> <none> <none> <none> <none> <none> <none> <none> <none> <none> <none> <none>
go to the boy from the bedroom 	_ go male <none> <none> <none> <none> <none> <none> <none> <none> <none> <none> <none> <none> <none> <none> <none> <none> <none>
ask him something 	_ ask male <none> <none> <none> <none> <none> <none> <none> <none> <none> <none> <none> <none> <none> <none> <none> <none> <none>
Can you bring me the lightest item in the microwave? 	_ bring object in microwave <none> <none> <none> operator <none> <none> <none> <none> <none> <none> <none> lightest <none> <none> <none>
On the baby chair, which three items weigh the most? 	_ find object on chair <none> <none> <none> operator <none> <none> <none> <none> <none> <none> name heaviest 3 <none> <none>
Pick up the chocoflake 	_ bring chocoflake <none> <none> <none> <none> <none> operator <none> <none> <none> <none> <none> <none> <none> <none> <none> <none> <none>
put it on the fireplace 	_ bring object <none> <none> <none> <none> <none> place on fireplace <none> <none> <none> <none> <none> <none> <none> <none> <none>
Show me the thinnest object on the bathroom cabinet. 	_ bring object on cabinet <none> <none> bathroom operator <none> <none> <none> <none> <none> <none> <none> thinnest <none> <none> <none>
get the item behind the shampoo that is on the stove 	_ bring object on stove behind shampoo <none> operator <none> <none> <none> <none> <none> <none> <none> <none> <none> <none> <none>
Find Morgan in the living room 	_ guide Morgan <none> <none> <none> <none> living_room operator <none> <none> <none> <none> <none> <none> <none> <none> <none> <none> <none>
then tell a joke. 	_ answer operator <none> <none> <none> <none> <none> <none> <none> <none> <none> <none> <none> joke <none> <none> <none> <none> <none>
Find Taylor in the bathroom 	_ guide Taylor <none> <none> <none> <none> bathroom operator <none> <none> <none> <none> <none> <none> <none> <none> <none> <none> <none>
state what day it is 	_ answer operator <none> <none> <none> <none> <none> <none> <none> <none> <none> <none> <none> date <none> <none> <none> <none> <none>
tell Robin what day it is. 	_ answer Robin <none> <none> <none> <none> <none> <none> <none> <none> <none> <none> <none> date <none> <none> <none> <none> <none>
Tell Tracy what day it is she is in the living room. 	_ answer Tracy <none> <none> <none> <none> living_room <none> <none> <none> <none> <none> <none> date <none> <none> <none> <none> <none>
Please find the cereal in the armchair 	_ bring cereal in chair <none> <none> <none> operator <none> <none> <none> <none> <none> <none> <none> <none> <none> <none> <none>
please go to the living room	_ go <none> <none> <none> <none> <none> living_room <none> <none> <none> <none> <none> <none> <none> <none> <none> <none> <none> <none>
of the people in the dining room, how many are male? 	_ find male <none> <none> <none> <none> dining_room operator <none> <none> <none> <none> <none> <none> count <none> <none> <none> <none>
In the bedroom, how many people are there lying down 	_ find person <none> <none> <none> <none> bedroom operator <none> <none> <none> <none> <none> <none> count <none> <none> lying <none>
find a person in the living room to answer a question 	_ answer person <none> <none> <none> <none> living_room <none> <none> <none> <none> <none> <none> <none> <none> <none> <none> <none> <none>
Answer the question of the person in the dining room. 	_ answer person <none> <none> <none> <none> dining_room <none> <none> <none> <none> <none> <none> <none> <none> <none> <none> <none> <none>
give napkin to the person on the left in the bathroom 	_ bring napkin <none> <none> <none> <none> <none> person left <none> <none> <none> bathroom <none> <none> <none> <none> <none> <none>
Count the objects on the baby chair 	_ find object on chair <none> <none> <none> operator <none> <none> <none> <none> <none> <none> count <none> <none> <none> <none>
come tell me. 	_ answer operator <none> <none> <none> <none> <none> <none> <none> <none> <none> <none> <none> <none> <none> <none> <none> <none> <none>
Find Jamie at the tv couch 	_ guide Jamie at couch <none> <none> <none> operator <none> <none> <none> <none> <none> <none> <none> <none> <none> <none> <none>
lead them to the stove 	_ guide person <none> <none> <none> <none> <none> place at stove <none> <none> <none> <none> <none> <none> <none> <none> <none>
LOOK FOR A GIRL IN THE KITCHEN 	_ guide female <none> <none> <none> <none> kitchen operator <none> <none> <none> <none> <none> <none> <none> <none> <none> <none> <none>
answer the question to a female person in the kitchen 	_ answer female <none> <none> <none> <none> kitchen <none> <none> <none> <none> <none> <none> <none> <none> <none> <none> <none> <none>
what are the three lightest items on the middle table 	_ find object on table <none> <none> <none> operator <none> <none> <none> <none> <none> <none> name lightest 3 <none> <none>
What are the heaviest things on the fireplace please? 	_ find object on fireplace <none> <none> <none> operator <none> <none> <none> <none> <none> <none> name heaviest <none> <none> <none>
GO to dining room 	_ go <none> <none> <none> <none> <none> dining_room <none> <none> <none> <none> <none> <none> <none> <none> <none> <none> <none> <none>
then tell a joke 	_ answer person <none> <none> <none> <none> <none> <none> <none> <none> <none> <none> <none> joke <none> <none> <none> <none> <none>
what's the biggest thing on top of the washing machine 	_ find object top washing_machine <none> <none> <none> operator <none> <none> <none> <none> <none> <none> name largest <none> <none> <none>
come back 	_ go operator <none> <none> <none> <none> <none> <none> <none> <none> <none> <none> <none> <none> <none> <none> <none> <none> <none>
Which are the three thinnest things in the microwave? 	_ find object in microwave <none> <none> <none> operator <none> <none> <none> <none> <none> <none> name thinnest 3 <none> <none>
What are the smallest objects at the washing machine? 	_ find object in washing_machine <none> <none> <none> operator <none> <none> <none> <none> <none> <none> name smallest <none> <none> <none>
Find the male in the corridor 	_ guide male in corridor <none> <none> <none> operator <none> <none> <none> <none> <none> <none> <none> <none> <none> <none> <none>
answer his question 	_ answer male <none> <none> <none> <none> <none> <none> <none> <none> <none> <none> <none> <none> <none> <none> <none> <none> <none>
Look for a boy in the bedroom 	_ guide male <none> <none> <none> <none> bedroom operator <none> <none> <none> <none> <none> <none> <none> <none> <none> <none> <none>
What are the three heaviest objects on the microwave? 	_ find object on microwave <none> <none> <none> operator <none> <none> <none> <none> <none> <none> name heaviest 3 <none> <none>
Tell me the three largest objects on the chair Robot. 	_ find object on chair <none> <none> <none> operator <none> <none> <none> <none> <none> <none> name largest 3 <none> <none>
could you meet tracy the side table 	_ guide Tracy at table <none> <none> <none> operator <none> <none> <none> <none> <none> <none> <none> <none> <none> <none> <none>
guide her to here 	_ guide female <none> <none> <none> <none> <none> operator <none> <none> <none> <none> <none> <none> <none> <none> <none> <none> <none>
guide him to here 	_ guide male <none> <none> <none> <none> <none> operator <none> <none> <none> <none> <none> <none> <none> <none> <none> <none> <none>
have him follow you 	_ guide male <none> <none> <none> <none> <none> <none> <none> <none> <none> <none> <none> <none> <none> <none> <none> <none> <none>
Deliver me the item behind the apple from the dresser 	_ bring object in dresser behind apple <none> operator <none> <none> <none> <none> <none> <none> <none> <none> <none> <none> <none>
retrieve object behind bowl from the washing machine. 	_ bring object in washing_machine behind bowl <none> operator <none> <none> <none> <none> <none> <none> <none> <none> <none> <none> <none>
Tell me what the lightest objects on the wardrobe are 	_ find object on wardrobe <none> <none> <none> operator <none> <none> <none> <none> <none> <none> name lightest <none> <none> <none>
reveal to me What is the slender article on the drawer 	_ find object on drawer <none> <none> <none> operator <none> <none> <none> <none> <none> <none> name thinnest <none> <none> <none>
Get the teaspoon from the cupboard 	_ bring teaspoon in cupboard <none> <none> <none> operator <none> <none> <none> <none> <none> <none> <none> <none> <none> <none> <none>
could you go to the cupboard 	_ go <none> at cupboard <none> <none> <none> <none> <none> <none> <none> <none> <none> <none> <none> <none> <none> <none> <none>
get me the teaspoon 	_ bring teaspoon <none> <none> <none> <none> <none> operator <none> <none> <none> <none> <none> <none> <none> <none> <none> <none> <none>
Find Alex in the corridor 	_ guide Alex at corridor <none> <none> <none> operator <none> <none> <none> <none> <none> <none> <none> <none> <none> <none> <none>
tell him what day it is 	_ answer male <none> <none> <none> <none> <none> <none> <none> <none> <none> <none> <none> date <none> <none> <none> <none> <none>
Find Tracy in the living room 	_ guide Tracy <none> <none> <none> <none> living_room operator <none> <none> <none> <none> <none> <none> <none> <none> <none> <none> <none>
say what day it is 	_ answer operator <none> <none> <none> <none> <none> <none> <none> <none> <none> <none> <none> date <none> <none> <none> <none> <none>
Move to bathroom 	_ go <none> <none> <none> <none> <none> bathroom <none> <none> <none> <none> <none> <none> <none> <none> <none> <none> <none> <none>
locate Tracy 	_ guide Tracy <none> <none> <none> <none> <none> operator <none> <none> <none> <none> <none> <none> <none> <none> <none> <none> <none>
provide self fact. 	_ answer operator <none> <none> <none> <none> <none> <none> <none> <none> <none> <none> <none> yourself <none> <none> <none> <none> <none>
Please get to the sink 	_ go <none> at sink <none> <none> <none> <none> <none> <none> <none> <none> <none> <none> <none> <none> <none> <none> <none>
meet the peach 	_ bring peach <none> <none> <none> <none> <none> operator <none> <none> <none> <none> <none> <none> <none> <none> <none> <none> <none>
what are the three tiny little items in the fireplace 	_ find object in fireplace <none> <none> <none> operator <none> <none> <none> <none> <none> <none> name smallest 3 <none> <none>
Answer the question of the person lying in the kitchen 	_ answer person <none> <none> <none> <none> kitchen <none> <none> <none> <none> <none> <none> <none> <none> <none> <none> lying <none>
Answer the question the person in the dining room has. 	_ answer person <none> <none> <none> <none> dining_room <none> <none> <none> <none> <none> <none> <none> <none> <none> <none> <none> <none>
Find someone in the bedroom 	_ guide person <none> <none> <none> <none> bedroom operator <none> <none> <none> <none> <none> <none> <none> <none> <none> <none> <none>
answer their question. 	_ answer person <none> <none> <none> <none> <none> <none> <none> <none> <none> <none> <none> <none> <none> <none> <none> <none> <none>
Find your way to the bedroom 	_ go <none> <none> <none> <none> <none> bedroom <none> <none> <none> <none> <none> <none> <none> <none> <none> <none> <none> <none>
locate someone 	_ guide person <none> <none> <none> <none> <none> operator <none> <none> <none> <none> <none> <none> <none> <none> <none> <none> <none>
find a person in the bathroom 	_ guide person <none> <none> <none> <none> bathroom operator <none> <none> <none> <none> <none> <none> <none> <none> <none> <none> <none>
answer their question 	_ answer person <none> <none> <none> <none> <none> <none> <none> <none> <none> <none> <none> <none> <none> <none> <none> <none> <none>
go to the person in the bathroom 	_ go person <none> <none> <none> <none> bathroom <none> <none> <none> <none> <none> <none> <none> <none> <none> <none> <none> <none>
Can you count how many cokes there are on the freezer? 	_ find coke on fridge <none> <none> <none> operator <none> <none> <none> <none> <none> <none> count <none> <none> <none> <none>
Identify the three biggest objects from the bookshelf. 	_ find object in bookshelf <none> <none> <none> operator <none> <none> <none> <none> <none> <none> name largest 3 <none> <none>
Give the bowl to the person in the living room waving. 	_ bring bowl <none> <none> <none> <none> <none> person <none> <none> <none> <none> living_room <none> <none> <none> <none> waving <none>
please show alex the way from the drawer to the shower 	_ guide Alex at drawer <none> <none> <none> place at shower <none> <none> <none> <none> <none> <none> <none> <none> <none>
What is the object on the cupboard that weights the most 	_ find object on cupboard <none> <none> <none> operator <none> <none> <none> <none> <none> <none> name heaviest <none> <none> <none>
from the wardrobe that is in the bedroom, tell me the name 	_ find object in wardrobe <none> <none> <none> operator <none> <none> <none> <none> <none> <none> name <none> <none> <none> <none>
Of the objects in the bedroom, could you locate three? 	_ bring object <none> <none> <none> <none> bedroom operator <none> <none> <none> <none> <none> <none> <none> <none> 3 <none> <none>
tell them a joke 	_ answer person <none> <none> <none> <none> <none> <none> <none> <none> <none> <none> <none> joke <none> <none> <none> <none> <none>
The person in the bathroom, please tell them the time. 	_ answer person <none> <none> <none> <none> bathroom <none> <none> <none> <none> <none> <none> time <none> <none> <none> <none> <none>
What are the three lightest items sitting on the table 	_ find object on table <none> <none> <none> operator <none> <none> <none> <none> <none> <none> name lightest 3 <none> <none>
Move the chips from the bathroom cabinet to the drawer 	_ bring chips in cabinet <none> <none> bathroom place on drawer <none> <none> <none> <none> <none> <none> <none> <none> <none>
Put the towel that is by the fridge on the towel rack. 	_ bring towel near fridge <none> <none> <none> place on towel_rack <none> <none> <none> <none> <none> <none> <none> <none> <none>
Find a boy in the living 	_ guide male <none> <none> <none> <none> living_room operator <none> <none> <none> <none> <none> <none> <none> <none> <none> <none> <none>
answer his question. 	_ answer male <none> <none> <none> <none> <none> <none> <none> <none> <none> <none> <none> <none> <none> <none> <none> <none> <none>
Please bring me the lightest thing on the coffee table 	_ bring object on table <none> <none> <none> operator <none> <none> <none> <none> <none> <none> <none> lightest <none> <none> <none>
Can you list the three largest objects on the cabinet? 	_ find object on cabinet <none> <none> <none> operator <none> <none> <none> <none> <none> <none> name largest 3 <none> <none>
Bring me the thing under the napkin from the armchair. 	_ bring object in chair under napkin <none> operator <none> <none> <none> <none> <none> <none> <none> <none> <none> <none> <none>
Robot, what are the lightest things in the dishwasher? 	_ find object in dishwasher <none> <none> <none> operator <none> <none> <none> <none> <none> <none> <none> lightest <none> <none> <none>
Go to the corridor 	_ go <none> at corridor <none> <none> <none> <none> <none> <none> <none> <none> <none> <none> <none> <none> <none> <none> <none>
explain what day it is to Alex. 	_ answer Alex <none> <none> <none> <none> <none> <none> <none> <none> <none> <none> <none> date <none> <none> <none> <none> <none>
Which three objects on the fireplace are the smallest? 	_ find object on fireplace <none> <none> <none> operator <none> <none> <none> <none> <none> <none> name smallest 3 <none> <none>
Relay to me how many people in the hall are not girls. 	_ find male in hallway <none> <none> <none> operator <none> <none> <none> <none> <none> <none> count <none> <none> <none> <none>
of the people in the bedroom, how many are lying down? 	_ find person <none> <none> <none> <none> bedroom operator <none> <none> <none> <none> <none> <none> count <none> <none> lying <none>
Find someone in the corridor 	_ guide person in corridor <none> <none> <none> operator <none> <none> <none> <none> <none> <none> <none> <none> <none> <none> <none>
Count the objects in the freezer 	_ find object in fridge <none> <none> <none> operator <none> <none> <none> <none> <none> <none> count <none> <none> <none> <none>
tell me the result 	_ answer operator <none> <none> <none> <none> <none> <none> <none> <none> <none> <none> <none> <none> <none> <none> <none> <none> <none>
Bring Michael from the center table to the dining table 	_ guide Michael at table <none> <none> <none> place at table <none> <none> <none> <none> <none> <none> <none> <none> <none>
Please find a girl in the bedroom 	_ guide female <none> <none> <none> <none> bedroom operator <none> <none> <none> <none> <none> <none> <none> <none> <none> <none> <none>
Bring me the biggest objects that are on the side table 	_ bring object on table <none> <none> <none> operator <none> <none> <none> <none> <none> <none> <none> largest <none> <none> <none>
I'd like the heaviest things from the towel rack please 	_ bring object in towel_rack <none> <none> <none> operator <none> <none> <none> <none> <none> <none> <none> heaviest <none> <none> <none>
what are the three lightest objects on the coffee table 	_ find object on table <none> <none> <none> operator <none> <none> <none> <none> <none> <none> <none> lightest <none> <none> <none>
Go to the living room 	_ go <none> <none> <none> <none> <none> living_room <none> <none> <none> <none> <none> <none> <none> <none> <none> <none> <none> <none>
tell me who is there by name. 	_ find person <none> <none> <none> <none> <none> operator <none> <none> <none> <none> <none> <none> name <none> <none> <none> <none>
tell someone the day of the week 	_ answer person <none> <none> <none> <none> <none> <none> <none> <none> <none> <none> <none> day_of_week <none> <none> <none> <none> <none>
give it to Morgan at the freezer. 	_ bring object <none> <none> <none> <none> <none> Morgan at fridge <none> <none> <none> <none> <none> <none> <none> <none> <none>
Detail the largest object located on the cutlery drawer 	_ find object on drawer <none> <none> <none> operator <none> <none> <none> <none> <none> <none> name largest <none> <none> <none>
What are the three largest things on the cutlery drawer 	_ find object on drawer <none> <none> <none> operator <none> <none> <none> <none> <none> <none> name largest 3 <none> <none>
from the cabinet tell me which are the smallest objects 	_ find object in cabinet <none> <none> <none> operator <none> <none> <none> <none> <none> <none> name smallest <none> <none> <none>
Find the boy in the living room 	_ guide male <none> <none> <none> <none> living_room operator <none> <none> <none> <none> <none> <none> <none> <none> <none> <none> <none>
look for a man in the living room 	_ guide male <none> <none> <none> <none> living_room operator <none> <none> <none> <none> <none> <none> <none> <none> <none> <none> <none>
Locate the person lying in the kitchen 	_ guide person <none> <none> <none> <none> kitchen operator <none> <none> <none> <none> <none> <none> <none> <none> <none> lying <none>
say what day 	_ answer operator <none> <none> <none> <none> <none> <none> <none> <none> <none> <none> <none> date <none> <none> <none> <none> <none>
what are the three heaviest objects on the coffee table 	_ find object on table <none> <none> <none> operator <none> <none> <none> <none> <none> <none> name heaviest 3 <none> <none>
Which of the three objects on the chair is the largest? 	_ find object on chair <none> <none> <none> operator <none> <none> <none> <none> <none> <none> name largest 3 <none> <none>
Look on the counter 	_ go <none> at counter <none> <none> <none> <none> <none> <none> <none> <none> <none> <none> <none> <none> <none> <none> <none>
tell me which item is littlest. 	_ find object <none> <none> <none> <none> <none> operator <none> <none> <none> <none> <none> <none> name smallest <none> <none> <none>
guide Tracy. 	_ guide Tracy <none> <none> <none> <none> <none> <none> <none> <none> <none> <none> <none> <none> <none> <none> <none> <none> <none>
Take the choco cereal 	_ bring chocoflake <none> <none> <none> <none> <none> operator <none> <none> <none> <none> <none> <none> <none> <none> <none> <none> <none>
place it inside the fireplace 	_ bring object <none> <none> <none> <none> <none> place into fireplace <none> <none> <none> <none> <none> <none> <none> <none> <none>
answer the question of someone sanding in the corridor. 	_ answer person in corridor <none> <none> <none> <none> <none> <none> <none> <none> <none> <none> <none> <none> <none> standing <none>
Get the soap in the sink 	_ bring soap in sink <none> <none> <none> operator <none> <none> <none> <none> <none> <none> <none> <none> <none> <none> <none>
bring it to the towel rack 	_ bring object <none> <none> <none> <none> <none> place on towel_rack <none> <none> <none> <none> <none> <none> <none> <none> <none>
Go to the coffee table 	_ go <none> at table <none> <none> <none> <none> <none> <none> <none> <none> <none> <none> <none> <none> <none> <none> <none>
meet the objects 	_ bring object <none> <none> <none> <none> <none> operator <none> <none> <none> <none> <none> <none> <none> <none> <none> <none> <none>
Please carry the water from the bed to the coffee table 	_ bring water in bed <none> <none> <none> place on table <none> <none> <none> <none> <none> <none> <none> <none> <none>
Please tell me the three biggest things on that cabinet 	_ find object on cabinet <none> <none> <none> operator <none> <none> <none> <none> <none> <none> name largest 3 <none> <none>
Robot, name the three biggest objects on the microwave. 	_ find object on microwave <none> <none> <none> operator <none> <none> <none> <none> <none> <none> name largest 3 <none> <none>
Say how many people are on the floor of the dining room 	_ find person <none> <none> <none> <none> dining_room operator <none> <none> <none> <none> <none> <none> count <none> <none> <none> <none>
TELL ME THE NUMBER OF PEOPLE LYING DOWN IN THE BEDROOM. 	_ find person <none> <none> <none> <none> bedroom operator <none> <none> <none> <none> <none> <none> count <none> <none> lying <none>
Answer the question of the person waving in the kitchen. 	_ answer person <none> <none> <none> <none> kitchen <none> <none> <none> <none> <none> <none> <none> <none> <none> <none> waving <none>
Answer the question the person in the kitchen is asking. 	_ answer person <none> <none> <none> <none> kitchen <none> <none> <none> <none> <none> <none> <none> <none> <none> <none> <none> <none>
Go into the bedroom 	_ go <none> <none> <none> <none> <none> bedroom <none> <none> <none> <none> <none> <none> <none> <none> <none> <none> <none> <none>
find someone 	_ find person <none> <none> <none> <none> <none> operator <none> <none> <none> <none> <none> <none> <none> <none> <none> <none> <none>
The person in the living room has a question, answer it. 	_ answer person <none> <none> <none> <none> living_room <none> <none> <none> <none> <none> <none> <none> <none> <none> <none> <none> <none>
what are the three largest items on top of the microwave 	_ find object top microwave <none> <none> <none> operator <none> <none> <none> <none> <none> <none> name largest 3 <none> <none>
Locate a woman in the kitchen 	_ guide female <none> <none> <none> <none> kitchen operator <none> <none> <none> <none> <none> <none> <none> <none> <none> <none> <none>
give the largest objects to me. 	_ bring object <none> <none> <none> <none> <none> operator <none> <none> <none> <none> <none> <none> name largest <none> <none> <none>
Please bring me the largest objects from the side table. 	_ bring object in table <none> <none> <none> operator <none> <none> <none> <none> <none> <none> <none> largest <none> <none> <none>
What is the object in the cupboard that is the heaviest? 	_ find object in cupboard <none> <none> <none> operator <none> <none> <none> <none> <none> <none> name heaviest <none> <none> <none>
reveal to me What is the heaviest article on the cupboard 	_ find object on cupboard <none> <none> <none> operator <none> <none> <none> <none> <none> <none> name heaviest <none> <none> <none>
What is the lightest thing on the cutlery drawer please? 	_ find object on drawer <none> <none> <none> operator <none> <none> <none> <none> <none> <none> name lightest <none> <none> <none>
Go towards the bathroom 	_ go <none> <none> <none> <none> <none> bathroom <none> <none> <none> <none> <none> <none> <none> <none> <none> <none> <none> <none>
tell a person about yourself 	_ answer person <none> <none> <none> <none> <none> <none> <none> <none> <none> <none> <none> yourself <none> <none> <none> <none> <none>
Tell someone in the dining room something about yourself 	_ answer person <none> <none> <none> <none> dining_room <none> <none> <none> <none> <none> <none> yourself <none> <none> <none> <none> <none>
Tell the person in the kitchen something about yourself. 	_ answer person <none> <none> <none> <none> kitchen <none> <none> <none> <none> <none> <none> yourself <none> <none> <none> <none> <none>
Get the pickles 	_ bring pickles <none> <none> <none> <none> <none> operator <none> <none> <none> <none> <none> <none> <none> <none> <none> <none> <none>
give it to Taylor at the baby chair. 	_ bring object <none> <none> <none> <none> <none> Taylor at chair <none> <none> <none> <none> <none> <none> <none> <none> <none>
find the biggest object on the cabinet 	_ bring object on cabinet <none> <none> <none> operator <none> <none> <none> <none> <none> <none> <none> largest <none> <none> <none>
hand it to me 	_ bring object <none> <none> <none> <none> <none> operator <none> <none> <none> <none> <none> <none> <none> <none> <none> <none> <none>
put the teaspoon on the counter which is in the bathtub 	_ bring teaspoon <none> <none> <none> <none> <none> place in tub on counter <none> <none> <none> <none> <none> <none> <none>
please bring me the lighter objects that are on the sofa 	_ bring object on sofa <none> <none> <none> operator <none> <none> <none> <none> <none> <none> <none> lightest <none> <none> <none>
please could you give me the lighter object of the board 	_ bring object on cupboard <none> <none> <none> operator <none> <none> <none> <none> <none> <none> <none> lightest <none> <none> <none>
Give me the largest items on top of the washing machine. 	_ bring object top washing_machine <none> <none> <none> operator <none> <none> <none> <none> <none> <none> <none> largest <none> <none> <none>
please bring me the bigest item from the couch by the tv 	_ bring object near tv in couch <none> operator <none> <none> <none> <none> <none> <none> <none> largest <none> <none> <none>
Can you please place the cereal to the bathroom cabinet. 	_ bring cereal <none> <none> <none> <none> <none> place on cabinet <none> <none> bathroom <none> <none> <none> <none> <none> <none>
bring it back. 	_ bring object <none> <none> <none> <none> <none> <none> <none> <none> <none> <none> <none> <none> <none> <none> <none> <none> <none>
go to the bookshelf 	_ go <none> at bookshelf <none> <none> <none> <none> <none> <none> <none> <none> <none> <none> <none> <none> <none> <none> <none>
Go to Alex at the towel rack 	_ go Alex at towel_rack <none> <none> <none> <none> <none> <none> <none> <none> <none> <none> <none> <none> <none> <none> <none>
tell him about yourself 	_ answer male <none> <none> <none> <none> <none> <none> <none> <none> <none> <none> <none> yourself <none> <none> <none> <none> <none>
Go tell me what the three smallest items on the sofa are 	_ find object on sofa <none> <none> <none> operator <none> <none> <none> <none> <none> <none> name smallest <none> <none> <none>
Find the person in the living room 	_ guide person <none> <none> <none> <none> living_room operator <none> <none> <none> <none> <none> <none> <none> <none> <none> <none> <none>
Head to the bathroom 	_ go <none> <none> <none> <none> <none> bathroom <none> <none> <none> <none> <none> <none> <none> <none> <none> <none> <none> <none>
Go look at the sink 	_ go <none> at sink <none> <none> <none> <none> <none> <none> <none> <none> <none> <none> <none> <none> <none> <none> <none>
tell me how many beers are there. 	_ find beer <none> <none> <none> <none> <none> operator <none> <none> <none> <none> <none> <none> count <none> <none> <none> <none>
What is the number of melon on the top of the dishwasher? 	_ find melon top dishwasher <none> <none> <none> operator <none> <none> <none> <none> <none> <none> count <none> <none> <none> <none>
Of the objects in the sink, which are the three thinnest? 	_ find object in sink <none> <none> <none> operator <none> <none> <none> <none> <none> <none> name thinnest 3 <none> <none>
tell me what objects are there. 	_ find object <none> <none> <none> <none> <none> operator <none> <none> <none> <none> <none> <none> name <none> <none> <none> <none>
Find Peyton at the freezer 	_ guide Peyton at fridge <none> <none> <none> operator <none> <none> <none> <none> <none> <none> <none> <none> <none> <none> <none>
go with him to the bedroom 	_ follow male <none> <none> <none> <none> <none> place at <none> <none> <none> bedroom <none> <none> <none> <none> <none> <none>
Find Alex at the cabinet 	_ guide Alex at cabinet <none> <none> <none> operator <none> <none> <none> <none> <none> <none> <none> <none> <none> <none> <none>
bring them to the baby chair 	_ guide person <none> <none> <none> <none> <none> place at chair <none> <none> <none> <none> <none> <none> <none> <none> <none>
Please identify the three lightest objects on the fridge. 	_ find object on fridge <none> <none> <none> operator <none> <none> <none> <none> <none> <none> name lightest 3 <none> <none>
Find someone in the bathroom 	_ guide person <none> <none> <none> <none> bathroom operator <none> <none> <none> <none> <none> <none> <none> <none> <none> <none> <none>
inform them of the time. 	_ answer person <none> <none> <none> <none> <none> <none> <none> <none> <none> <none> <none> date <none> <none> <none> <none> <none>
tell a joke too 	_ answer operator <none> <none> <none> <none> <none> <none> <none> <none> <none> <none> <none> joke <none> <none> <none> <none> <none>
What are the three lightest things on the cutlery drawer? 	_ find object on drawer <none> <none> <none> operator <none> <none> <none> <none> <none> <none> name lightest 3 <none> <none>
Inform me of which items on the cabinet are the littlest. 	_ find object on cabinet <none> <none> <none> operator <none> <none> <none> <none> <none> <none> name smallest <none> <none> <none>
find a boy 	_ guide male <none> <none> <none> <none> <none> operator <none> <none> <none> <none> <none> <none> <none> <none> <none> <none> <none>
answer the question to the boy who inside the living room 	_ answer male <none> <none> <none> <none> living_room <none> <none> <none> <none> <none> <none> <none> <none> <none> <none> <none> <none>
find a male person in the bedroom 	_ guide male <none> <none> <none> <none> bedroom operator <none> <none> <none> <none> <none> <none> <none> <none> <none> <none> <none>
find a male person on the bedroom 	_ guide male <none> <none> <none> <none> bedroom operator <none> <none> <none> <none> <none> <none> <none> <none> <none> <none> <none>
Hand me the object from the dresser that weighs the least 	_ bring object in dresser <none> <none> <none> operator <none> <none> <none> <none> <none> <none> <none> lightest <none> <none> <none>
hand me whatever weighs the least from the dresser please 	_ bring object in dresser <none> <none> <none> operator <none> <none> <none> <none> <none> <none> <none> lightest <none> <none> <none>
in the baby's chair, what are the three heaviest objects? 	_ find object in chair <none> <none> <none> operator <none> <none> <none> <none> <none> <none> name heaviest 3 <none> <none>
Can you tell the largest objects at the bathroom cabinet? 	_ find object on cabinet <none> <none> bathroom operator <none> <none> <none> <none> <none> <none> name largest <none> <none> <none>
what are the three biggest things on top of the fireplace 	_ find object top fireplace <none> <none> <none> operator <none> <none> <none> <none> <none> <none> name largest 3 <none> <none>
Tell me whats the most miniature item on the center table 	_ find object on table <none> <none> <none> operator <none> <none> <none> <none> <none> <none> name smallest <none> <none> <none>
Can you please get the big dish 	_ bring dish <none> <none> <none> <none> <none> operator <none> <none> <none> <none> <none> <none> <none> largest <none> <none> <none>
put it in the shower? 	_ bring object <none> <none> <none> <none> <none> place in shower <none> <none> <none> <none> <none> <none> <none> <none> <none>
Answer the question of a person standing in the corridor. 	_ answer person in corridor <none> <none> <none> <none> <none> <none> <none> <none> <none> <none> <none> <none> <none> standing <none>
find the person in the bathroom 	_ guide person <none> <none> <none> <none> bathroom operator <none> <none> <none> <none> <none> <none> <none> <none> <none> <none> <none>
Go to the cupboard 	_ go <none> at cupboard <none> <none> <none> <none> <none> <none> <none> <none> <none> <none> <none> <none> <none> <none> <none>
get the teaspoon 	_ bring teaspoon <none> <none> <none> <none> <none> operator <none> <none> <none> <none> <none> <none> <none> <none> <none> <none> <none>
Please get the milk from the microwave 	_ bring milk in microwave <none> <none> <none> operator <none> <none> <none> <none> <none> <none> <none> <none> <none> <none> <none>
give it to me. 	_ bring object <none> <none> <none> <none> <none> operator <none> <none> <none> <none> <none> <none> <none> <none> <none> <none> <none>
Get to the dining room 	_ go <none> <none> <none> <none> <none> dining_room <none> <none> <none> <none> <none> <none> <none> <none> <none> <none> <none> <none>
find Robin 	_ guide Robin <none> <none> <none> <none> <none> operator <none> <none> <none> <none> <none> <none> <none> <none> <none> <none> <none>
tell her a joke 	_ answer female <none> <none> <none> <none> <none> <none> <none> <none> <none> <none> <none> joke <none> <none> <none> <none> <none>
tell him a joke 	_ answer male <none> <none> <none> <none> <none> <none> <none> <none> <none> <none> <none> joke <none> <none> <none> <none> <none>
Robot, how many people are lying down in the dining room? 	_ find person <none> <none> <none> <none> dining_room operator <none> <none> <none> <none> <none> <none> count <none> <none> lying <none>
Find a person in the living room 	_ guide person <none> <none> <none> <none> living_room operator <none> <none> <none> <none> <none> <none> <none> <none> <none> <none> <none>
Find someone who is in the corridor 	_ guide person in corridor <none> <none> <none> operator <none> <none> <none> <none> <none> <none> <none> <none> <none> <none> <none>
Navigate to bedroom 	_ go <none> <none> <none> <none> <none> bedroom <none> <none> <none> <none> <none> <none> <none> <none> <none> <none> <none> <none>
navigate to kitchen 	_ go <none> <none> <none> <none> <none> kitchen <none> <none> <none> <none> <none> <none> <none> <none> <none> <none> <none> <none>
navigate to the room 	_ go <none> <none> <none> <none> <none> <none> <none> <none> <none> <none> <none> <none> <none> <none> <none> <none> <none> <none>
navigate me to the room 	_ guide operator <none> <none> <none> <none> <none> place at <none> <none> <none> <none> <none> <none> <none> <none> <none> <none>
navigate him to the bedroom 	_ guide male <none> <none> <none> <none> <none> place <none> <none> <none> <none> bedroom <none> <none> <none> <none> <none> <none>
navigate her to the living room 	_ guide female <none> <none> <none> <none> <none> place <none> <none> <none> <none> living_room <none> <none> <none> <none> <none> <none>
Let me know what the three largest objects on the sink are 	_ find object on sink <none> <none> <none> operator <none> <none> <none> <none> <none> <none> name largest 3 <none> <none>
Can you identify the three thinnest objects from the sink? 	_ find object in sink <none> <none> <none> operator <none> <none> <none> <none> <none> <none> name thinnest 3 <none> <none>
Retrieve what is to the right of the glass by the tv couch 	_ bring object near couch right glass <none> operator <none> <none> <none> <none> <none> <none> <none> <none> <none> <none> <none>
Find Taylor at the center table 	_ guide Taylor at table <none> <none> <none> operator <none> <none> <none> <none> <none> <none> <none> <none> <none> <none> <none>
take them to the sofa. 	_ guide person <none> <none> <none> <none> <none> place at sofa <none> <none> <none> <none> <none> <none> <none> <none> <none>
guide them to the sofa 	_ guide person <none> <none> <none> <none> <none> place at sofa <none> <none> <none> <none> <none> <none> <none> <none> <none>
get escort michael from baby chair 	_ guide Michael at chair <none> <none> <none> place at <none> <none> <none> <none> <none> <none> <none> <none> <none> <none>
move to the counter 	_ go <none> at counter <none> <none> <none> <none> <none> <none> <none> <none> <none> <none> <none> <none> <none> <none> <none>
find the woman 	_ guide female <none> <none> <none> <none> <none> operator <none> <none> <none> <none> <none> <none> <none> <none> <none> <none> <none>
Let me know what the thee lightest items on the fridge are 	_ find object on fridge <none> <none> <none> operator <none> <none> <none> <none> <none> <none> name lightest 3 <none> <none>
On the center table, which are the three lightest objects? 	_ find object on table <none> <none> <none> operator <none> <none> <none> <none> <none> <none> name lightest 3 <none> <none>
Identify the three heaviest objects placed on the dresser. 	_ find object on dresser <none> <none> <none> operator <none> <none> <none> <none> <none> <none> name heaviest 3 <none> <none>
Report to me what the name of the person in the bedroom is 	_ find person <none> <none> <none> <none> bedroom operator <none> <none> <none> <none> <none> <none> name <none> <none> <none> <none>
Detail the three lightest objects located on the armchair. 	_ find object on chair <none> <none> <none> operator <none> <none> <none> <none> <none> <none> name lightest 3 <none> <none>
What three objects in the cutlery drawer are the lightest? 	_ find object on drawer <none> <none> <none> operator <none> <none> <none> <none> <none> <none> name lightest 3 <none> <none>
Find the biggest item from the cabinet. 	_ bring object in cabinet <none> <none> <none> operator <none> <none> <none> <none> <none> <none> <none> largest <none> <none> <none>
Answer a question for the boy you find in the dining room. 	_ answer male <none> <none> <none> <none> dining_room <none> <none> <none> <none> <none> <none> <none> <none> <none> <none> <none> <none>
Please tell me the largest objects in the bathroom cabinet 	_ find object in cabinet <none> <none> bathroom operator <none> <none> <none> <none> <none> <none> name largest <none> <none> <none>
answer the question to the person standing in the bathroom 	_ answer person <none> <none> <none> <none> bathroom <none> <none> <none> <none> <none> <none> <none> <none> <none> <none> standing <none>
Look on the drawer 	_ go <none> at drawer <none> <none> <none> <none> <none> <none> <none> <none> <none> <none> <none> <none> <none> <none> <none>
tell me which item is the thinnest. 	_ find object <none> <none> <none> <none> <none> operator <none> <none> <none> <none> <none> <none> name thinnest <none> <none> <none>
Go hand me the item on the bathroom cabinet under the coke 	_ bring object under coke <none> <none> bathroom operator <none> <none> <none> <none> <none> <none> <none> <none> <none> <none> <none>
give me object it was under the teaspoon from the dresser 	_ bring object under teaspoon in dresser <none> operator <none> <none> <none> <none> <none> <none> <none> <none> <none> <none> <none>
I want the chips from the chair, can you bring them to me? 	_ bring chips in chair <none> <none> <none> operator <none> <none> <none> <none> <none> <none> <none> <none> <none> <none> <none>
Find Alex in the bathroom 	_ guide Alex <none> <none> <none> <none> bathroom operator <none> <none> <none> <none> <none> <none> <none> <none> <none> <none> <none>
tell him the day of the week 	_ answer male <none> <none> <none> <none> <none> <none> <none> <none> <none> <none> <none> day_of_week <none> <none> <none> <none> <none>
Find Alex out in the hallway 	_ guide Alex in hallway <none> <none> <none> operator <none> <none> <none> <none> <none> <none> <none> <none> <none> <none> <none>
find hayden in the dining room 	_ guide Hayden <none> <none> <none> <none> dining_room operator <none> <none> <none> <none> <none> <none> <none> <none> <none> <none> <none>
follow the shampoo when you saw it. 	_ follow person <none> <none> <none> <none> <none> <none> <none> <none> <none> <none> <none> <none> <none> <none> <none> <none> <none>
remove the soap from the sink 	_ bring soap in sink <none> <none> <none> operator <none> <none> <none> <none> <none> <none> <none> <none> <none> <none> <none>
put it in the towel rack 	_ bring object <none> <none> <none> <none> <none> place in towel_rack <none> <none> <none> <none> <none> <none> <none> <none> <none>
Detail the three largest objects located on the microwave. 	_ find object on microwave <none> <none> <none> operator <none> <none> <none> <none> <none> <none> name largest 3 <none> <none>
Find the person lying in the corridor 	_ guide person in corridor <none> <none> <none> operator <none> <none> <none> <none> <none> <none> <none> <none> <none> lying <none>
The person in the living room has a question, go answer it. 	_ answer person <none> <none> <none> <none> living_room <none> <none> <none> <none> <none> <none> <none> <none> <none> <none> <none> <none>
Can you find out how many glasses there are in the cupboard 	_ find glass in cupboard <none> <none> <none> operator <none> <none> <none> <none> <none> <none> count <none> <none> <none> <none>
Please identify how many glasses are there on the cupboard. 	_ find glass on cupboard <none> <none> <none> operator <none> <none> <none> <none> <none> <none> count <none> <none> <none> <none>
On the bathroom cabinet, which three items are the largest? 	_ find object on cabinet <none> <none> bathroom operator <none> <none> <none> <none> <none> <none> name largest 3 <none> <none>
What are the three narrowest objects on the couch by the TV 	_ find object near tv on couch <none> operator <none> <none> <none> <none> <none> <none> name thinnest 3 <none> <none>
let me know what the three thinnest objects on the sofa are 	_ find object on sofa <none> <none> <none> operator <none> <none> <none> <none> <none> <none> name thinnest 3 <none> <none>
Put the chocoflake to the left person in the dining room. 	_ bring chocoflake <none> <none> <none> <none> <none> person left <none> <none> <none> dining_room <none> <none> <none> <none> <none> <none>
find out how many items are in there. 	_ find object <none> <none> <none> <none> <none> operator <none> <none> <none> <none> <none> <none> count <none> <none> <none> <none>
Meet Taylor at the center table 	_ find Taylor at table <none> <none> <none> <none> <none> <none> <none> <none> <none> <none> <none> <none> <none> <none> <none>
escort them to the sofa 	_ guide person <none> <none> <none> <none> <none> place at sofa <none> <none> <none> <none> <none> <none> <none> <none> <none>
